di	that
</s>	this
e	</s>
che	in
la	and
in	the
il	and
per	this
a	</s>
un	</s>
l	has
del	that
è	made
le	and
della	and
non	and
i	and
delle	and
dei	an
dell	has
commissione	european
si	</s>
una	of
alla	in
con	in
al	</s>
onorevole	transport
regioni	on
sono	</s>
questo	the
presidente	other
relazione	that
ha	the
da	</s>
anche	</s>
più	this
parlamento	no
signor	if
nel	</s>
come	and
stati	</s>
all	sector
politica	and
ma	in
unione	of
mi	enough
fondi	this
se	be
gli	and
sviluppo	and
sia	research
cui	sustainable
nella	that
alle	</s>
europea	these
linee	and
direttrici	taking
stato	the
ai	this
strutturali	year
essere	will
lavoro	</s>
lo	affected
tale	</s>
quanto	your
sicurezza	areas
modo	that
su	that
degli	i
nelle	this
ci	european
membri	</s>
o	that
coesione	and
onorevoli	when
questa	and
mio	as
trasporti	being
sulla	them
regionale	sector
gruppo	shall
punto	also
signora	same
europa	1
dal	at
hanno	regional
tutti	market
commissario	have
dalla	</s>
particolare	the
nell	goods
ciò	large
tutto	four
sociale	and
obiettivo	time
colleghi	demand
loro	between
molto	that
paesi	competitiveness
prima	whole
tali	tell
importante	more
già	union
nei	time
programmi	in
europeo	might
ad	this
occupazione	regions
discussione	implementing
agli	convergence
pertanto	committee
proposta	he
giorno	and
sul	de
merci	and
sua	improved
solo	whose
d	period
pericolose	request
fra	economy
tra	last
settore	off
vorrei	quaestors
siamo	fact
programma	eu
ho	</s>
fatto	well
importanza	a
noi	over
parte	requirements
quali	stated
volta	social
maggiore	</s>
due	socialists
direttiva	do
politiche	and
situazione	information
desidero	considering
sulle	and
rurale	union
trasporto	mr
perché	policies
alcuni	principle
priorità	level
obiettivi	parliament
emendamenti	main
periodo	vote
ordine	employment
oggi	hand
norme	take
quando	our
fondo	and
1	in
attenzione	by
lei	regions
relatrice	</s>
regionali	hatzidakis
questione	again
economica	that
secondo	i
favore	his
sempre	aid
relatore	involvement
dall	way
suo	on
abbiamo	very
molti	taken
caso	start
parlamentari	we
proprio	rules
programmazione	together
nostra	and
ed	council
conto	s
quindi	had
occorre	wulf
sarebbe	this
ruolo	transported
era	want
problemi	have
sui	from
soprattutto	programming
cittadini	data
2000	plan
ancora	always
1999	introduce
ultraperiferiche	country
nazionali	this
sostegno	accept
può	said
tuttavia	particular
aree	structural
analisi	not
strada	berend
accordo	mrs
interno	particularly
misure	</s>
mia	we
disoccupazione	community
nostro	guidelines
materia	include
infine	place
competitività	challenges
innanzi	section
nostri	measures
dato	analysis
merito	any
quale	this
svolto	work
grande	and
soltanto	involved
tema	railways
invece	pointed
anni	president
qualità	rural
tenere	approach
grado	decision
meno	the
collega	and
crescita	necessary
devono	and
dibattito	and
altro	</s>
dai	guidance
sede	ourselves
ne	achieving
imprese	programmes
processo	some
koch	agriculture
ora	me
vita	this
posizione	national
sull	because
inoltre	providing
stata	then
uno	speech
quella	account
posti	private
berend	item
nostre	and
esame	and
periodica	and
risorse	this
sarà	it
deve	opportunities
votazione	programming
zone	and
altri	negotiations
rurali	proposed
sesta	let
garantire	forget
possibile	and
considerazione	certain
emendamento	in
fare	</s>
condizioni	answered
livello	sri
credo	adopted
tipo	aim
fa	pay
estremamente	support
volte	increase
fine	essential
sociali	effort
schroedter	group
2006	clear
me	materialise
dire	establishing
2	that
io	find
creare	but
modifica	that
ritengo	are
risultati	should
queste	agree
opportuno	planning
galles	stressed
progetti	importance
questi	day
dunque	view
qualche	type
ringrazio	º
rispetto	commission
momento	against
dobbiamo	coordination
infatti	for
base	extremely
tutte	january
vista	not
voi	and
presentare	urban
territorio	transposed
così	few
de	this
progetto	not
pare	resistance
politico	still
decisione	that
quest	parliament
dello	by
fronte	process
altresì	most
possibilità	projects
regione	issue
anno	action
negli	about
utilizzo	raise
generale	addition
purtroppo	terrible
motivo	and
consiglio	european
punti	were
dopo	human
tanto	of
domani	efficient
poter	proposal
siano	we
gestione	week
principio	face
appena	such
dalle	towards
conclusioni	indicators
ambiente	responsible
certo	review
spesso	number
dovrebbe	damage
venga	affairs
applicazione	months
durante	already
intervento	dictates
quello	there
tratta	initiative
promuovere	therefore
testo	flexibility
migliorare	happen
presentata	cannot
lavori	is
seconda	explanations
nome	like
futuro	both
cen	order
settimana	increasing
quattro	despite
orientamenti	opinion
fornire	report
aumento	would
armonizzazione	how
strutturale	into
primo	help
settori	of
nuovo	personal
massimo	ask
esempio	amend
tal	current
vengono	not
cioè	before
possa	out
appunto	basically
opportunità	companies
requisiti	bearing
ue	firstly
osservazioni	peripheral
vi	minutes
responsabilità	fall
piuttosto	wales
realtà	fundamental
adesso	familiar
voto	subject
bisogno	paragraph
nuova	and
aspetto	party
allo	wrote
chiedo	light
incidenti	hear
effetti	2
locali	developments
avuto	execution
alcune	her
sottolineare	remind
intervenire	authorities
turismo	people
senso	good
raggiungere	competitive
ambito	longer
nonostante	20
nuovi	area
meglio	that
richiesta	very
infrastrutture	its
dare	in
finanziamenti	and
economico	the
comunque	given
pari	this
necessario	</s>
vari	</s>
maggior	has
strategia	that
scorso	made
coloro	and
relazioni	so
abbia	strategy
impegno	and
tempo	their
creazione	an
presidenti	first
nuove	working
parere	</s>
attività	of
cinque	specifically
prodi	countries
ricordo	germany
poi	transport
quadro	on
debba	case
contro	two
idea	other
piccole	that
seguito	member
efficacia	social
decisioni	do
interventi	now
isole	no
corso	if
conferenza	</s>
valutazione	within
chiaramente	regarding
grave	sector
nazionale	major
possono	in
miglioramento	of
procedura	enough
paese	this
agricoltura	be
ogni	gentlemen
trattato	road
precedente	research
regolamento	sustainable
giovedì	zoning
data	jobs
possiamo	these
ricordato	feel
far	taking
mentre	the
pratica	great
coordinamento	year
comune	will
stessa	</s>
sottolineato	affected
detto	position
privato	your
prossimo	areas
riforma	roads
attuazione	line
nonché	i
strumento	present
partenariato	european
va	delays
febbraio	france
oppure	sea
autorità	when
discutere	examination
povere	as
parola	being
necessità	them
europei	september
numero	shall
luogo	also
sue	same
preme	1
chiedere	at
potuto	regional
ringraziare	market
certa	have
disposizioni	activity
dati	the
cosa	goods
stiamo	large
presentato	four
aspetti	done
visto	highlight
servizi	demand
sufficientemente	between
congratularmi	economic
passato	competitiveness
deputati	whole
promozione	tell
società	more
ripresa	union
maggiormente	time
necessaria	relating
dovremmo	might
intenzione	a5
ricordare	regions
causa	document
mercato	convergence
finanziario	committee
contenuto	he
mezzi	you
gravi	de
assicurare	and
minime	improved
tengo	whose
consulenti	period
ritardo	request
luce	economy
particolarmente	last
verbale	off
gran	quaestors
fase	fact
successo	eu
formulare	spent
poiché	well
terzo	a
attualmente	over
attiene	requirements
partito	stated
riferimento	social
efficace	amendment
motivi	socialists
medie	could
conclusione	appropriate
farlo	information
permettere	by
gruppi	urging
sostenibile	stand
mai	mr
discusso	policies
possano	principle
metà	level
senza	parliament
verso	main
giovani	vote
formazione	employment
invito	hand
contesto	take
però	our
conformemente	right
pubblico	initiatives
principali	difficult
misura	regions
evans	integrated
pil	hatzidakis
termini	again
presente	granted
ampliamento	i
sapere	his
posso	aid
diversi	involvement
nuovamente	way
riguardo	asking
donne	medium
né	taken
lettera	start
intendo	we
articolo	rules
ragione	together
chiesto	and
centrale	council
relativa	s
adottate	had
proposito	wulf
vero	fire
locale	transported
problema	want
competenze	have
ultimi	from
tre	programming
c	data
rafforzare	plan
ppe	always
avrà	introduce
erano	country
ritardi	due
persone	accept
stesso	said
esso	particular
essenziale	structural
relative	relatively
vigore	berend
spero	mrs
carattere	particularly
legislatura	citizens
finanziamento	we
convergenza	community
sfida	guidelines
brevemente	include
differenze	place
proprie	challenges
iniziative	section
gennaio	measures
conseguenza	analysis
urbano	any
presentati	does
nello	work
comunicazione	concern
ben	involved
iniziativa	railways
revisione	pointed
assolutamente	president
mesi	rural
prendere	approach
attraverso	decision
approvazione	short
evoluzione	hard
regole	necessary
avviso	2000
osservazione	alone
aula	deal
controllo	guidance
buona	ourselves
insulari	achieving
contiene	programmes
ferrovia	some
opinione	agriculture
plenaria	me
voti	moor
gradi	national
qui	because
interesse	in
votare	then
tenuto	speech
soffermarmi	account
fiducia	private
termine	item
significa	temperatures
esse	urban
burocrazia	namely
finora	shown
conseguenze	it
affinché	opportunities
troppo	programming
politici	undertaken
investimenti	negotiations
popolazione	proposed
prescindere	let
direzione	forget
rilevare	and
progressi	certain
comunitarie	25
sviluppate	say
valutare	answered
provenienti	sri
uso	adopted
tornata	aim
varie	pay
presentate	support
riferisco	increase
state	essential
documento	effort
riflessione	group
indubbiamente	clear
percento	materialise
titolo	establishing
miei	generally
prossimi	find
economie	but
º	the
economiche	are
raccomandazioni	should
risposta	agree
sarebbero	planning
insieme	stressed
ricerca	importance
fonti	day
tutta	view
viene	type
po	º
migliore	commission
austria	against
ormai	coordination
formulato	for
atto	extremely
naturalmente	january
economia	trends
aspettiamo	internal
responsabile	urban
abitante	transposed
perfettamente	few
riguarda	indeed
forte	not
indicatori	and
fatti	still
elaborazione	targets
difficile	response
sì	by
rispondere	process
flessibilità	most
finalmente	projects
paragrafo	issue
dichiarazione	action
via	about
transito	raise
poco	addition
c5	terrible
buone	young
ritenuto	levels
parlando	were
legislativo	human
prescrizioni	least
incidente	efficient
capacità	proposal
ricche	experts
ottimale	week
indicare	face
adeguata	such
concernente	towards
appoggio	indicators
tecnologie	responsible
ridurre	review
insistito	various
seduta	damage
aiuti	affairs
contributo	months
argomento	already
applicabili	dictates
mettere	there
costruire	initiative
pesca	therefore
fondamentali	flexibility
chiusa	happen
confronti	cannot
saranno	is
barón	explanations
adeguate	like
ce	both
trovare	order
approvate	increasing
vicepresidente	despite
agricole	opinion
sufficiente	report
concludendo	would
personale	how
procedere	into
domanda	help
equilibrio	types
navigabili	personal
vie	ask
migliori	amend
piani	current
parlamentare	lanka
generali	before
sforzo	out
dimenticare	basically
presentazione	companies
sforzi	bearing
so	firstly
informazione	peripheral
evitare	minutes
tunnel	fall
aver	wales
impatto	fundamental
palacio	familiar
fini	subject
accogliere	paragraph
partecipare	proceeding
disparità	party
altrettanto	wrote
settembre	depth
industriale	hear
recentemente	2
dimostrato	developments
specifiche	execution
comitato	her
orientale	remind
ecco	authorities
dovrà	people
europee	good
ovvero	competitive
eletti	longer
negoziati	20
voglio	area
linea	us
sottolinea	date
casi	on
maggioranza	one
governo	this
periferiche	set
istituzioni	given
avevo	this
consiste	</s>
azione	and
colpite	has
minuto	looking
avanzare	advisers
reddito	and
urgente	with
rappresentanti	five
previsto	than
ravvicinamento	risks
dubbio	made
addirittura	first
criteri	working
proposto	sized
ulteriormente	three
rischio	creation
reti	put
comunitari	form
rappresenta	very
com	on
analizzare	presidents
socialismo	environment
serie	other
tecnico	reasons
espresso	been
resta	effective
chiediamo	rating
altra	going
stanno	cooperation
seri	if
imprenditorialità	a
abbiano	representatives
agricolo	maximum
utilità	next
collaborazione	and
passo	this
strategico	plan
carico	enough
resto	this
reca	sums
affari	gentlemen
a5	debated
devo	details
relativi	legislative
vengano	zoning
livelli	either
proposte	cold
temperature	it
eccellente	taking
intervenuti	degree
disposizione	amendments
socialista	tell
potenziale	will
ridotta	institutions
15	rail
realizzazione	improving
proponiamo	going
entro	areas
aziende	able
intesa	it
attirare	point
divario	its
interne	this
comunità	plenary
povertà	in
finanziari	either
20	when
davvero	c
competente	as
poveri	among
soluzione	competence
dimostra	consideration
britannico	our
grazie	november
questioni	electronic
addizionalità	points
occasione	presenting
desidera	recommendations
coinvolgimento	effect
territoriale	have
uniti	arguments
preoccupazioni	the
spese	unfortunately
trasparente	book
esecuzione	storms
personalmente	today
istruzione	highlight
francese	demand
mancanza	non
poettering	departments
ricchezza	competitiveness
unito	whole
stesse	tell
riduzione	aware
rassicurarvi	industry
qualsiasi	time
anch	relating
piacere	rose
sollevare	laid
obiezione	included
regno	certainly
modificato	catastrophic
citato	balanced
sicuramente	he
legislativa	knowledge
decentrato	please
piano	objectives
modifiche	improved
assai	proposals
potenziamento	period
entrata	hague
offrire	economy
partire	obliged
breve	off
incremento	quaestors
porti	comments
massima	away
catastrofe	political
considerare	sectors
strade	we
dovuto	over
desiderio	interpretation
1200	interaction
55	fruteau
silenzio	anxious
accolti	crucial
1997	do
tempeste	cen
tecnologico	quality
svolgere	rather
intervengo	1998
rendere	yet
suddetta	agricultural
comporterebbe	sitting
costi	role
procedure	development
sri	remind
risulta	sudre
lanka	need
riguardano	parliamentary
collegio	improve
futuri	possible
organizzazione	our
statistiche	right
pur	like
soddisfare	itself
suddetti	because
considerazioni	briefly
rischi	hatzidakis
fruteau	again
risalto	at
lentezza	improving
tempestivamente	differences
verificati	years
vantaggio	involvement
millennio	post
mezzo	asking
essi	medium
germania	late
italia	convenient
accettare	getting
colpiti	rules
catastrofi	men
naturali	speaking
unico	council
relativo	s
dove	contains
qualcosa	wulf
chiamati	minute
compiuti	greater
provocato	farmers
propone	have
funzionamento	poor
dipartimenti	guidelines
ampiamente	item
francesi	develop
vatanen	alert
avere	supporting
preparazione	assessing
flessibili	severely
accade	conference
dovuti	happening
fossero	point
sullo	structural
orientamento	1999
preso	berend
suoi	mrs
consulente	particularly
dimensione	turn
introdurre	we
cose	easier
sezione	guidelines
evocato	position
potrà	vatanen
concludere	these
correttamente	section
capitolo	be
pienamente	kept
erika	tomorrow
numerosi	term
compito	0004
maggio	colleges
approvati	draw
ferroviario	capital
media	although
trasparenza	introduced
congratulo	prosperous
mese	measures
inferiore	diversity
assistere	explain
sotto	hard
esprimere	actually
ultimo	c
carenze	cities
altre	deal
ulteriore	improves
constatazione	ourselves
buon	achieving
ammettere	will
dagli	know
socioeconomica	also
potere	thus
giungere	establish
trovato	of
atti	because
situazioni	providing
1998	rule
agricoltori	unemployment
ultima	euro
patrimonio	attentive
condizione	members
città	festive
alcun	result
inserito	namely
crespo	instructive
approva	excluding
dando	economies
posto	less
sperequazioni	undertaken
serio	lack
disponibilità	secondly
forse	considerably
positivo	poorer
spirito	until
mercoledì	precisely
tutela	chiefly
questori	</s>
tenute	answered
potrebbe	sri
rivedere	adopted
debbano	aim
chiaro	key
sfide	subsequent
esperienza	finnish
diritto	essential
consentito	people
vuole	rules
presa	cases
almeno	facts
embargo	establishing
esiste	politicians
avanti	those
adottato	long
perdita	presented
entrare	supplements
indonesia	setting
codice	agree
considerato	planning
diversa	strictly
appello	problem
poche	inject
25	draft
geografica	we
aggiunte	broke
vedere	optimum
votato	groun
dovrebbero	coordination
mondo	led
strumenti	suggests
luglio	january
orario	average
olandese	better
globalizzazione	adult
avrò	transposed
ricevuto	background
volti	speed
denaro	directives
riusciremo	silence
disposta	still
deboli	considers
disponibili	has
chiave	small
rapidamente	another
intermedia	new
membro	maximum
fuori	to
ottima	moment
contribuire	engaged
finanziati	associations
altrimenti	addition
riunione	path
amministrativa	required
passare	safety
approvata	important
disuguaglianze	time
definitiva	others
temi	efficient
van	fight
discorso	personally
prodotto	week
noto	daring
governi	used
tratti	towards
essenziali	0104
wulf	she
mathies	application
avrebbe	emphasises
spetta	issue
avrebbero	furthermore
stampa	sufficiently
sostenere	strategic
nota	dictates
trattamento	there
concluso	initiative
adeguatamente	national
omissione	link
sistema	this
occupazionali	can
principi	is
dichiarazioni	prepared
lotta	like
avevamo	inland
energia	committee
sostenuto	increasing
ottenuto	below
lungo	prodi
pronti	report
distanza	granting
speriamo	saying
disoccupati	into
bene	play
rinnovabili	reform
realizzare	finland
quel	ask
vogliamo	weak
sta	current
hatzidakis	sector
conformità	duty
nesso	your
verificare	constructed
struttura	companies
completamente	bearing
spesa	letter
imposta	incentives
grandi	minutes
sviluppare	europe
costituisce	parliament
continua	fundamental
rappresentano	early
giovanile	states
definizione	paragraph
rilievo	tunnels
inserire	party
amsterdam	wrote
periferici	vast
cuore	hear
troviamo	2
vigente	centres
bensì	pacts
bisogni	her
ovviamente	disgraceful
comprese	supported
istituire	reason
normalizzazione	unacceptably
terreno	red
cospicui	longer
inutili	regulatory
orientata	etc
permanente	involve
rivestono	practical
ovviare	concept
modificare	in
connesse	everyday
imprenditore	pleasing
sistemi	indicated
convinto	sir
inequivocabile	sometimes
penso	secto
precedenti	concentration
esperti	wee
modalità	corresponding
contribuito	realise
esercizio	build
inseriti	eventually
sperati	changes
comitatologia	5
tempi	i
processi	coup
indicazioni	marginalised
logico	represented
sudre	relations
desidererei	raises
complesso	quotation
negativa	intrinsically
formulati	require
ascoltato	on
ciascuno	think
scuola	body
scadenze	session
continuerà	away
trattandosi	reflect
raggiunge	thursday
seguenti	tunnel
ottenere	fact
berlino	international
necessari	needs
quantitativi	hänsch
definito	characterised
essa	short
globalmente	problems
accompagnamento	far
1994	imply
quarto	circumstances
finanziare	upon
sussidiarietà	america
maggiori	definition
affidabilità	partnership
includere	reiterated
centri	advisors
swoboda	viewpoint
condotta	describes
richiede	harmonising
sé	vice
strategica	climates
impone	not
competenza	admiration
prospere	networks
merita	permission
frutti	which
rapporti	schemes
mccarthy	profit
sostanzialmente	position
diverse	operate
associo	growing
infrastrutturali	integrating
svezia	efforts
lordo	original
tipi	giving
produrre	will
concorrenza	satisfy
approccio	madeira
produttività	phase
avanzata	labour
apprezzamento	services
integrato	advisors
158	pose
attribuita	land
scarsa	evening
occupazionale	areas
giustamente	themselves
terremo	framework
rack	outlines
attribuire	news
occorrerà	local
regolamentazione	basis
dichiarato	twofold
evidenziare	even
integrata	geographical
strategie	inherent
integrate	starting
urbane	continue
2003	representative
legislazioni	women
aumentare	faced
lunga	applicable
successiva	competent
funzionari	competitiveness
transitorie	obstructing
fervore	schools
rendimento	behind
esigere	organisation
sviluppati	1993
caratterizzato	evans
eccessiva	doing
sarò	assure
pubblici	2003
dam	notice
allegati	brainpower
tuttora	chairman
prova	concerne
dedicata	than
principale	conversion
approfondito	suggested
dovremo	ones
prioritario	presentl
dirmi	approximation
elevati	developing
lavoriamo	tool
fatta	2007
fanno	have
delineare	pillars
incentivi	indicated
svolgerà	eu
chi	wait
equamente	allow
199	table
lanciato	pleasure
94	month
giusta	invite
giudizio	called
negative	thousands
predecessore	heart
difficoltà	four
segnalati	flexibly
indica	preferred
continuiamo	urgency
documenti	sorry
talune	her
citarli	developed
adotterà	regard
commenti	chance
vostre	relevant
suggerimenti	minister
partenza	dawn
concreti	intended
intese	respect
prese	responsibilities
cos	regular
en	underwater
raggiungimento	disasters
richieste	seriously
vuoi	itself
concentrare	prior
sembrare	integrated
intensità	down
pilastri	enter
10	disaster
qual	interesting
là	though
feaog	presentation
fornisce	comparison
spazio	including
esclusivamente	speed
urbana	zero
negativamente	external
impiego	austria
trovano	times
valenza	0107
utili	deaths
evidenti	belatedly
rappresento	end
offerta	follows
richiesto	march
seno	careful
tener	endorsed
diversità	preaching
crescente	july
zero	competently
comunicazioni	devote
accettiamo	best
circostanze	creating
talvolta	far
condannano	past
pubblicazione	return
impulso	country
tramite	harmful
forza	activities
nn	van
sugli	justification
umane	creating
flautre	hours
insufficienti	tankers
comprensione	quota
fosse	opportunity
energetiche	smaller
memoranda	1994
scrive	lot
avremmo	referred
esigenze	threshold
quasi	producing
abitanti	figure
auspicato	historic
origine	repea
sfavorite	smes
legato	pursuing
produzione	decisive
terziario	immediate
commercio	seek
anzi	undoubtedly
atteggiamento	commissioner
registra	422
campo	decisio
cerca	london
status	whilst
affrontare	com
costruttivo	bernié
lieto	technical
esclusione	enforcing
criterio	are
tessuto	insignificant
crescendo	net
fin	administration
propria	importantl
enormi	production
taluni	ante
prioritari	intensive
tenga	cold
quelle	employment
capitale	standards
adeguato	forces
richiedono	available
critiche	taken
intollerabile	extraordinarily
pianificazione	speech
lapponia	liked
passata	chairmen
inevitabili	drive
sec	budgetary
elementi	traffic
clima	and
nordiche	air
proporre	impression
alto	changing
contribuenti	clarity
starebbe	rebuild
identificare	inherent
recupero	follow
costretti	reliability
avvio	partly
auspicio	you
garanzia	lasted
ampia	defending
fattispecie	island
suggerisco	advances
violato	tunnel
prospettiva	adopted
basta	crash
trattiamo	acceding
cambiamenti	of
amministrazioni	motives
utilizzati	asked
reale	following
stabilire	group
cisterne	commission
chiarezza	arms
vedremo	drafting
299	mentio
prossima	pass
opera	separates
patti	domestic
strutturalmente	netherlands
settentrionale	takes
consentire	words
vasta	regarded
territoriali	34
specialmente	denied
illustra	commenting
ambiti	really
compreso	safe
costruzione	related
specifici	offers
operato	multiannual
offra	worrying
bilancio	interpret
succede	embargo
vanno	richest
settimane	prerequisites
lunghe	side
riconosciuto	stagnation
dialogo	usefulness
preparare	responded
quelli	sources
marea	elimination
riprese	shifted
necessitano	state
dovuta	envy
francia	causes
facendo	spanish
celerità	benefits
materiali	connection
savary	15
vigile	ships
competitive	consequences
coerente	pronounced
elevate	exile
evidente	orientated
prevedere	standards
indispensabile	islands
limito	hence
messe	day
dimenticato	yourselves
tocca	lapland
sinergie	means
partecipazione	having
portata	10
conseguire	angelilli
dico	equitably
imprenditori	easy
creatori	promotion
pratiche	being
riteniamo	amending
conseguimento	interest
imprimere	marks
intero	cox
permesso	favour
america	disbursement
scala	subsidiarity
rende	distribution
progressiva	must
positiva	frost
inutile	brake
nera	desired
terza	continuing
parlare	ruling
freddo	opinions
contempo	substantiates
possibili	reports
34	reading
presidenza	faster
armi	while
risultato	deserves
favorevole	0107
ricordano	revision
responsabili	calling
proporzioni	critical
lato	into
stragrande	own
segnale	relate
intende	total
corretto	serious
certi	units
visita	remain
giovane	5
novembre	before
dieci	out
centro	overcome
intervenuto	strongest
rilasciare	scale
sarei	amsterdam
gravità	doubtless
innumerevoli	actual
lui	her
auspica	eaggf
messaggio	fields
lettura	in
perciò	assessed
scors	praise
odierna	299
terribile	years
esito	seattle
aveva	television
perso	conservative
annunciato	modest
comportamento	fault
stradali	execution
ferroviari	boosting
internazionale	unanimously
determinate	opportunity
pubblica	prior
texas	heard
vigenti	abroad
dedicare	wednesday
fallimento	17
relativamente	gives
interrogazioni	us
orale	adhere
prego	listen
interrogazione	voting
constatare	disregards
apertura	sometimes
coraggio	aimed
verificatisi	elsewher
testi	my
basa	openness
morte	accepts
favorevoli	organisation
condannato	partners
interessati	everything
precedenza	europe
esprimersi	fairer
presto	dangerous
inserite	redevelopment
competenti	impetus
preciso	nothing
applausi	restructuring
giornale	several
beneficiato	majority
parla	with
banchi	investment
interruzione	form
enorme	propose
concordato	impact
considerando	presidents
piedi	users
9	adequate
potremmo	scrutiny
navigabile	sign
internet	multi
iscritto	has
assolto	involved
allora	something
consentirci	immediately
ascoltare	adhere
accesso	representatives
riserve	taxpayer
elaborare	decisively
accetto	approving
richiamare	apply
oltre	d
rinunciare	priority
volentieri	quite
piccolo	15
insufficiente	officials
conforme	drew
sciagura	details
essendo	legislative
abbattute	struck
danni	weight
esaminare	bound
accordi	occurred
sentire	boost
ossia	base
alexander	temporary
cod	regarded
nikitin	structurally
hnsch	myself
accontentarci	him
unanimità	i
inizialmente	ensures
sottoscritto	explosions
posizioni	1994
recenti	address
cox	sustainability
sappiamo	yo
alcuna	government
profitto	intentioned
trarne	go
dover	send
denunciare	7
dispiace	c
colmare	question
iniziale	truly
occhi	schroedter
vittime	struck
comuni	comitology
implica	second
insediamento	dwellers
informazioni	produced
attuale	analyse
presso	recommendations
siete	produce
trattati	have
diretti	fertile
istituzione	serve
genere	unfortunately
osservare	income
evidentemente	texts
ribadito	sadly
potranno	meeting
verrà	secondly
faccia	distance
sufficienti	requested
respinge	penalties
prove	overseas
contrari	vehicle
canali	expense
quei	industry
dicembre	play
incendio	anxious
chiede	rose
decisamente	add
oggetto	raised
fondamentale	historical
mie	ownership
romano	balanced
manca	rapidly
pensiamo	meticulous
morale	please
ciascun	often
gestire	35
rientra	retained
ritirato	emphasis
semplice	efficiency
suddetto	century
canale	strike
nutre	certainly
ribadisco	confident
sessione	keen
affermare	universities
preferito	political
rinnovo	conferred
pone	southern
esistono	exceptionally
adesione	hoc
complimenti	insufficient
venisse	diversification
gradirei	scale
norma	guarantee
permetta	inadmissible
esattamente	cen
espressa	quality
17	thi
aumentato	1998
salute	substance
contrario	recovery
integrare	call
rispettiamo	accidents
finlandesi	shifting
quinquennio	paint
rallegro	sudre
corretta	arrangement
funzioni	seasonal
stabilito	vacuum
aderiranno	palacio
sento	lies
annuali	discredited
2001	hi
disposti	renew
egli	whom
rigorosi	refusing
deciso	drafte
eventuali	aparicio
illustri	trumpeted
concordi	improving
rispettare	detailed
mancato	competition
assemblea	damaged
sebbene	possibly
figura	asking
comunitario	every
paiono	late
uffici	convenient
faremo	highly
fino	introducing
ebbene	idea
cada	impoverished
avvia	resulted
tardivamente	constructively
consultato	chapeau
primis	forward
carica	nevertheless
angelilli	enter
rispettivi	close
3	lived
costantemente	directly
formulate	factors
prestigio	0120
richiamati	unnecessary
ciascuna	alert
giusto	skills
comunitaria	inadequate
dibattute	severely
egualmente	act
giustifica	successfully
esige	brittan
cofinanziamento	essentially
collegamenti	apply
spetti	dilemma
realmente	logic
settennio	expected
iniziati	3
membr	educated
delicato	somewhat
rivolto	workers
opportunamente	unemployed
orientare	wee
sospendere	true
condanna	wishes
sens	substantial
giuridico	reaching
assegnazione	guideline
attribuisca	useful
divenire	0004
stabilità	reality
legga	aided
graziare	rigorous
permane	reinforce
aumenta	status
delineato	substantive
godere	quoted
segni	pse
precisi	explain
farò	operability
flotte	numerous
intersettoriali	power
eccessive	dared
facilitare	entails
sovvertirlo	improves
tiene	paid
monica	strategies
attim	50
tornerò	know
scadenz	urgent
consapevoli	once
governatore	establish
attentamente	amended
affidabile	man
ritenuta	providing
destinata	makes
caratterizzata	something
rafforzata	2127
imminenza	reservation
europ	standardisation
grech	festive
salvaguardia	schroedte
elezioni	sole
intraprendere	taxation
presentandomi	delegating
acquisisce	islander
ambientale	reserve
bush	traditional
aspettative	parts
rafforzamento	make
sostengo	expanding
quell	ours
ministro	prevention
gerarchico	austrian
costituito	suggest
voler	management
uomini	shape
lungi	sentenced
monetaria	damaging
puerta	remembered
espresse	key
riconversione	writing
sostenibili	carefully
attribuiscono	proving
madera	questions
altezza	sweden
redigere	establishes
supplementare	worde
chance	intersectoral
23	effectiveness
incontro	impose
preoccupazione	stretched
partecipato	holding
spiegazione	exists
apparente	setting
semmai	raschhofe
velocità	constructive
inaccettabile	soon
particolar	individuals
personalment	underspends
servizio	here
umana	decide
ingiustificabile	spend
rimane	missed
diseredate	belief
scarto	investor
relatric	farm
coincidenza	satisfied
pregiudiziale	inadmissibility
sventare	supply
alibi	elisabeth
osserv	owner
bei	paddington
quartieri	governments
periferie	advertising
equilibrata	enjoy
contemplano	literacy
orizzontali	examine
constata	oil
rivolgendomi	mistaken
fissata	vague
valorizzando	contained
includo	causing
tematiche	responsibility
leva	nations
petizione	home
passione	hitherto
strategiche	renovation
intelligenze	views
inammissibile	vocational
intorno	using
socioeducativi	inaugural
associazioni	executed
articolano	originated
vostro	active
forme	envisages
firmatari	federal
affermato	corroborate
seppänen	week
parlo	performance
giuridicamente	modernisation
propriamente	followed
prestazioni	0104
riserva	december
bradbourn	purposes
ricorso	ready
indirizzo	linked
contribuiscano	youth
attuali	sufficiently
raccolte	advance
partenariat	dictates
chiameremo	treatment
espressamente	initiative
pagina	complete
5	link
hicks	greece
proroga	demonstrate
scritto	imagine
ricordar	prepared
sollecitat	justifying
interpellato	remoteness
siffatto	statistics
castro	simple
ribeiro	recommendation
esperienze	committed
deputato	represent
potrei	granting
lontane	took
lontananza	includes
zimeray	play
attivo	powers
trattasse	reads
poterlo	recall
sincerit	clear
aggiungo	cofinancing
duraturi	plays
solidi	duty
inevitabilmente	heading
reperire	coasts
redditività	closely
concessione	newspaper
scroedter	definitively
ingenti	incentives
somme	exercises
risoluzioni	revitalise
inizio	mediterranean
esborsi	81
vaghi	early
interrompere	sections
rivelatosi	cunha
chiedono	departments
attuabili	steer
cosicché	wrote
assunta	colleague
correnti	disappearing
guida	excluded
definiti	presently
solida	record
farle	repor
sostanziali	appear
togliere	reiterate
renderla	attempted
pertinente	ill
servire	broadly
riversate	findings
illustrare	leaving
ragionamento	treat
utilizzate	test
esposta	entered
insegna	inherent
esaminerò	regretted
probità	useless
finanziaria	interventions
inutilmente	distributed
barents	explicitly
benefici	fisheries
farà	terribly
mare	sixth
contrastando	flautre
ricerche	damaging
tentazione	questions
tirare	developing
controllare	partnershi
continuando	comply
assorbire	congratulates
soldi	equilibrium
localizzati	perceive
darà	planned
appoggerà	aspect
illustrato	organisations
storici	confident
esborso	partially
contribuente	matter
sindrome	free
russe	inactivity
spendere	signs
portare	earlier
cambino	discontent
metodi	health
usati	polic
buono	disbursed
introdurrà	creates
indicati	maintained
realismo	models
cambiato	direct
bozza	exists
mirano	friendly
difficili	minds
tenuta	chapter
consentirebbe	subordinate
alimentare	absolutely
destinati	meaning
spediti	fit
veniamo	barents
armonizzare	costly
previdenza	overall
olandesi	februar
unificata	infrastrucutres
vago	badly
ridà	low
compiendo	alexander
voteremo	entrepreneurship
complimentare	region
ottimo	0122
est	goal
precise	fell
protesa	coinciding
problematica	mix
rafforza	lies
dilagare	hot
ineguaglianze	3
scenario	díez
plausibile	forward
approfondirsi	redondo
frenare	greatest
rilancio	staircases
telegiornale	criteria
mira	monopoly
gradiremmo	internationally
mensile	enforced
realizzarlo	neither
estendere	9
esilio	another
ridistribuzione	adr
cauti	ponnambalam
potermi	simplifying
alzare	goods
fede	island
west	protecting
midlands	stay
riservati	governing
stasera	self
lampante	mandate
stregua	intolerable
partorire	implemented
idee	aviation
grandiose	cocilovo
prive	adopt
consistenza	ways
rivelano	ability
immediatamente	defined
intento	iso
scarso	diversification
portoghese	thought
enormemente	23
utilizzare	calls
potenzialità	hop
intenzioni	particula
dia	enterprises
impegni	management
carente	monitoring
costituiti	exacerbates
operatori	represented
economici	demographic
concludo	wholehearted
dicendo	observe
riservata	conservation
televisivi	russia
femminile	forthcoming
concernenti	love
sancito	passionately
preoccupano	segni
voci	face
scemando	crossed
pensare	dedicating
trova	yourselves
espressi	abreast
vorremmo	undertake
imprescindibile	specify
azzorre	slow
monetari	naturally
colgo	add
spiegarci	industries
ragioni	played
attende	fill
russia	boosting
ribadendo	refuse
segnano	disparity
risibile	speakers
inesistente	secto
messo	smoking
desolazione	closed
attuate	suggestions
vasti	initial
strati	ribeiro
repressive	limit
contrariamente	renewable
cambiamento	lagging
rotta	climate
nulla	annually
lascia	root
ipotizzare	3
cambiare	understands
costituzione	widen
visione	seeking
uomo	intentions
appartengo	technological
volto	onto
inserisse	heart
positive	particula
segue	telling
unanime	running
operano	compulsory
parità	groups
innovativi	submit
donna	little
rivestiva	documents
trascurato	rejects
molteplici	says
stiano	charged
aiutando	channels
meravigliosamente	enhance
arretrate	seppänen
lieti	excessive
pretesa	eldr
catalogo	imagine
originario	9
condivido	ex
procedano	cod
semplificazione	universities
sottoscrivo	discuss
tribunale	imply
colossali	agreements
elevata	pursue
manodopera	control
fissando	regret
chiari	minor
alternative	body
ivi	fulfil
compresi	removed
beneficio	shores
consenta	compensate
intelligenza	dispose
giudiziario	unacceptably
efficaci	votes
risultano	gdp
visibili	c5
cittadino	sure
trae	urged
errore	requests
semplicemente	ratings
mano	executed
diretto	buildings
neppure	2123
prestare	harmonising
risoluzion	disgraceful
scontrano	october
ostacoli	tauern
completo	dissatisfied
assistenz	at
finanziariamente	steps
sostenibil	differ
dignitoso	benefit
criminali	half
elemosina	administrative
reati	educational
spinta	mathies
ponti	heritage
v	237
rappresentino	person
atte	profitable
commesso	legislation
restano	definition
accusare	paragraph
inammissibilmente	any
assicurarne	catastrophic
approfondiscono	absent
colossale	contained
massa	told
attenuata	fifths
aggravata	treaties
ricorrerà	brake
irrimediabile	natural
drammatiche	entrepreneurship
meridione	aggravates
parole	failed
pericolosamente	fischler
soffermarsi	austere
contenuti	immediately
ministero	deeply
accusa	confused
rendersi	result
accelerazione	poverty
registrata	strictly
mutare	treaty
scavare	integration
sottomarini	pse
collegarle	minimal
continente	internationally
onde	instruments
potersi	rate
adattare	constantly
agevolmente	enabling
separa	check
potendo	lacks
comportate	refer
avvento	occasional
auguriamo	unable
numerose	backed
dinanzi	obtaining
inquietudine	law
lavorare	stop
subordinato	someone
dipendente	livelihood
equa	accumulation
provengono	unilaterally
umili	compliment
figli	significant
svilupparsi	training
positivamente	beneficial
cercano	confused
lavoratore	hicks
aggiungere	uniting
imparare	poorest
operosità	continued
moda	relativises
indice	clarify
invidia	parliament
avendo	overcome
manciata	hasten
ospedali	certificate
gente	prosperity
reagisce	grew
andando	resolve
guadagnarsi	treason
pane	children
altrove	don
medesimo	evaluation
scuole	decentralised
secondi	fulfils
costoso	willingness
vivere	factor
desse	righ
terribili	don
incentivare	schroedte
proprietà	containers
azienda	harmonised
nutrirlo	unquestionably
fiscalità	rapporteur
dapprima	gorsel
rinviato	recommended
prime	burden
riflessioni	romano
inducono	conclude
ottimismo	summarise
lancio	subsidies
solenne	volume
tradurre	manage
difesa	pertains
produzioni	limits
tradizionali	attitude
concrete	substance
audaci	held
ambiziose	secretary
resteranno	principal
morta	tying
tasso	aims
andrò	construction
dritto	sensitive
materializzato	persons
baco	feared
distribuiti	matched
duramente	reopen
drammatici	exodus
isola	without
abissali	went
37	show
congiunturale	guide
insularità	conceded
personalità	left
determinare	commissione
farvi	hospitals
specifico	slowly
derogatorio	note
aumentate	perfectly
sensato	koch
spostando	interfaces
accento	flexibilisation
svariati	fundamentally
frattempo	hopefully
giunge	elements
prefissati	fair
raggiunti	edge
lasci	conversion
essersi	measure
ridotte	recognition
omogeneità	population
calato	northern
irrisoria	fashion
persino	awaited
dipenda	impetus
inefficienza	successful
aumentano	location
soddisfacente	monetary
quantomeno	coming
nemmeno	reluctantly
degni	genuine
riluttanza	hicks
giustificata	page
dubbi	proof
sorgono	worth
sommarsi	bernié
sembra	extensive
parliamo	invite
conoscono	lives
rientrano	tabled
memoria	weak
interessate	useful
concedendo	entry
concordo	midlands
lì	code
quotidiana	vast
credibilità	assistance
sostenut	reluctant
oserei	capabilities
mirabilment	instrument
portogallo	arrangements
grecia	did
gareggiato	apply
influisce	materials
venticinque	simpson
direbbe	stability
coup	synergies
chapeau	unequivocally
cappello	company
avete	system
nazione	ter
rimangono	affect
rimproverato	ease
giorni	convinced
chiedersi	introduced
criticamente	military
perseguita	brandenburg
innalzamento	involve
presupposti	forefront
riforme	ratify
fiscale	progress
traduca	everyday
perseguire	links
riesce	communications
durevoli	sir
tenesse	sometimes
riesca	mention
quota	offices
riduca	book
significativa	definitions
fusione	interim
guidata	adapting
fischler	eventually
assicurarvi	old
sforzerà	sho
interrotta	1989
presterà	adjacent
andrebbero	marginalised
soffermato	loaded
capo	sure
periodiche	raises
comportare	sincerely
rigoroso	limit
dichiaro	4
stimolare	six
raccolta	hat
rappresentativi	feet
richiamato	entrepreneurship
interessa	fourthly
venerdì	grateful
cocilovo	single
ripresi	being
inchieste	deserves
eurostat	appealing
aparicio	needs
sánchez	consultative
mancata	characterised
oriental	bit
dimensioni	tailor
limitate	meet
settor	force
affatto	environmental
trascurabil	upon
concentrazione	inequalities
ristretto	diverted
facilita	access
integrazione	happy
ottenuta	bodies
nogueira	experience
román	describes
ritengono	second
rimanga	entry
punt	instructions
apporto	40
molte	admiration
decennio	sudre
umanista	permission
profila	instructive
primi	floor
preadesione	organise
sspa	official
prossime	generate
vedete	irresponsible
sinceramente	integrating
franchezza	unknown
ann	disagreed
transfrontalieri	sustainability
sforzerò	bug
attenermi	renewal
note	employees
realizzato	phase
significativi	territorial
pohjamo	0122
cenno	employ
recuperato	equality
apportato	land
continueranno	observance
apportare	days
significativo	initial
modelli	framework
macroeconomici	british
indicano	memory
indicato	lowered
influenzata	cornerstones
fattori	twofold
markov	0106
poc	cargo
raschhofer	reassure
vacanze	superb
dotazione	person
stranieri	representative
migliorata	income
telegraficamente	faced
fissazione	applicable
negoziato	introducing
parti	penalties
associativo	needed
enti	surveys
promotori	requirement
trascorso	finding
avrete	loss
fiasco	follows
oratori	prosperity
precisa	resources
suggerite	2003
stanziamenti	notice
consentita	brainpower
vado	direction
errato	practically
abbiate	143
sensibili	behind
teneva	producers
consentisse	oversight
salto	catastrophe
21	poettering
esamina	annexes
definizioni	consequently
promossa	strengthened
scambio	removed
petersen	relations
quinto	quarters
positivi	agenda
motivazione	outcomes
complicata	willing
informo	table
organizzare	pleasure
seminario	migration
hedkvist	castro
divisione	called
applicata	viable
mappatura	heart
ritenersi	vocational
soddisfatto	7
avranno	preferred
elenco	met
sommersa	nuisance
avvenuto	ad
primaria	statement
speranza	favourable
auguri	inasmuch
ripartiti	uncontrolled
cominciare	reserves
esserci	protection
stagnazione	north
recessione	discussion
generano	responsibilities
ribatterete	2127
penuria	disintegration
valgono	school
periodi	presents
ripartirla	avalanche
assenza	territory
decenni	endeavouring
or	concentrating
realizzati	energy
verificatesi	matter
99	improvement
006	interventions
0120	adapted
2123	comparison
segna	spend
passaggio	speed
mette	reliability
invitarla	bomb
quinta	austria
vera	times
medio	original
violente	managing
immagine	powerful
monca	speaking
trasmesso	establishment
proclamato	endeavour
fondata	careful
maltempo	nevertheless
differenza	republic
cercato	july
chiarire	assisting
vist	devote
sottoposte	wurtz
confortare	respecting
concezione	content
discorsi	alert
opportuna	loose
tratte	practically
pacifica	expecte
valida	enjoyed
cooperazione	abide
riconciliazione	define
consolidata	further
0107	cargo
congratula	hours
sottolineando	interpretation
legame	directorate
periferia	redistribute
esita	undoubtedly
espliciti	leave
policentrico	latest
lanciata	ppe
conti	activities
segnatamente	peaceful
autore	iso
globale	demonstrated
81percento	smes
kumar	concept
migliorerà	cos
migliora	sort
unità	seek
tecnologica	thank
speciale	friend
relativizza	accused
morti	ensure
condoglianze	method
oltremare	observe
approvato	under
invita	23
riservare	milestone
inviasse	enforcing
danneggiati	158
specificamente	recitals
prossimamente	fell
venuto	stern
argomentazioni	prolongs
interessanti	grow
ottica	ante
ponnambalam	intensive
equilibrato	listening
sanzione	influence
valutazioni	standards
ex	hasten
ante	firm
specificare	courts
riescono	extraordinarily
confermo	speech
nutrire	quickly
quote	listen
sostituire	fleet
peraltro	arrangement
dichiararlo	inhabitant
ministri	confident
tampere	2001
redondo	impression
jiménez	faster
rispondono	u
duplice	additions
scorsa	grant
discorrendo	hidden
prende	reliability
attengono	seminar
vademecum	abc
metodologico	endeavouring
portavoce	entirely
affermazione	city
ricollocata	death
collegato	tunnel
primavera	leaders
attenuta	though
prevede	acceding
vocazione	assessments
indicativi	motives
pertinenti	asked
concordate	influential
letteralmente	decentralisation
raccomandazione	layers
143	june
colpito	drafting
coste	humanist
richiamo	met
suggerimento	separates
riservo	domestic
coincide	supervisory
seguirò	alternative
trarre	get
lottare	16
approverà	backward
carta	realistic
riconosciute	breach
lussemburgo	lankan
fornirà	commend
recherò	passing
gravemente	common
pluriennali	multiannual
sorta	0105
riconoscono	kinds
diversificazione	detail
cofinanziata	richest
6	records
multifunzionalità	exercise
iscritta	strongly
auspico	usefulness
moneta	decreased
cunha	magnificent
formulerò	allow
specifica	tend
ultime	transit
ricollega	considers
inammissibilità	wants
prevista	innocent
lezioni	harmed
veda	steer
assoluta	ports
citati	ships
marginalmente	innovative
sostenibilità	adapting
impostazione	representations
ingiustificata	sentenced
tengano	societies
summenzionati	islands
adottata	since
letto	uk
brandeburgo	166
conosco	investments
mozione	profile
parallelamente	having
speciali	harmonises
sovvenzionati	angelilli
appropriati	college
unicamente	easy
telecomunicazioni	promotion
inserendo	debating
ferroviarie	sent
transeuropee	affect
2007	marks
indifferente	centre
attive	knows
preferibilmente	regulation
previsti	ultraperipheral
applicando	distribution
determinazione	tonight
sperequazione	west
storico	realistic
pecche	adapt
giornali	happen
emarginazione	undeveloped
ricadute	appropriately
disparati	expeditiously
espulsi	presidency
produttivo	concluded
flessibile	scenario
conciliare	rejection
personali	create
favorire	drafted
approfondita	supervision
stimolando	thorough
lavoratori	critical
tenta	into
crescere	sadly
desumere	drafted
cautela	societies
alzarvi	protect
sortiscono	appreciate
effetto	remain
sperato	differently
osserva	obstacle
auspicata	located
mancano	urgency
basi	initially
autonoma	ghost
contribuisce	fertile
3percento	doubtless
ulteriori	actual
concentrandosi	opposite
ammodernamento	40
auspicati	formally
effettuare	adapted
razionalizzazione	importantl
associato	accident
alquanto	55
attuare	kumar
professionale	seattle
reinserimento	television
nettamente	conservative
rapporto	modest
periodico	fault
esplosioni	manage
disuguale	hospitals
teatro	requires
rapida	location
crescono	children
ritmo	unacceptably
sesto	indonesia
superiore	accident
meridionale	17
continuano	someone
segnare	worst
cause	eighteen
fenomeno	vivid
ovunque	transition
assassinii	assessed
rilevanti	employee
unica	intending
individui	approving
competitivo	aparicio
presenta	friend
preziose	construction
riassumo	amendmen
ricordate	madam
conseguiti	exciting
colpa	innovative
fattore	condition
decisivo	formulas
diminuzione	chairmanship
avvicinare	abstentions
vincolare	19
ordigni	card
approvare	gradual
presenti	currently
sottoposta	reconciliation
tangibile	operability
desume	6
preoccupante	entering
sentito	16
237	deletes
coincidono	health
corrispondono	enactment
4	exciting
riuscita	rich
destinate	until
inequivocabilmente	resulting
combattere	liked
appropriata	complicated
spesi	permanent
male	that
statali	bridge
centralizzate	cohesion
consentano	bureaucracy
distanze	highlights
caldo	guarantees
densità	minds
assicurando	worry
rimanere	otherwise
impatti	wednesday
ridotto	portugal
inciso	strengthening
partner	assisting
televisione	owing
bisognose	ensuring
flusso	creates
migratorio	incomes
motore	manne
avanguardia	relates
operanti	above
appoggia	fourth
verificano	unemploymen
ignoranza	system
coscienziosità	exclusion
pregevole	lesser
occupa	communautaire
addetto	uncertainty
nazioni	luxembourg
unite	commerce
svolti	2006
sforzarsi	cooperate
dirci	leader
continuo	ie
rassegnarci	maintained
avanzamento	full
organizzazioni	year
summenzionate	includes
accelerare	thorough
adottando	minimum
notevolmente	best
funzionare	overarching
diviene	check
dotarsi	delayed
pure	recognise
sostanziale	disabled
trasformi	elections
contingenti	shipment
variano	commissione
semplici	summit
terrebbe	couple
settentrionali	lapland
addetti	poorest
rigide	scant
conducenti	valuable
imballaggi	treatment
regolamentazioni	insensitive
lontano	badly
redazione	hence
necessarie	contributing
molta	analysed
permettono	caused
testimoniano	topical
rispecchierà	counted
parlava	harmonises
inferiori	agenda
riuscito	pleasing
40	building
porterebbero	participation
formula	becoming
complementari	identify
dimostrano	financial
varietà	accurate
climatica	hitherto
informare	move
0106	advertising
venissero	objection
fermerebbero	román
confini	postponing
senz	143
0208	anti
adozione	hypothesis
definita	individually
austriaco	dramatic
on	auditing
0105	enforcement
rifletterà	pursue
facciamo	pursuing
completa	partly
ottobre	frameworks
rammarichiamo	nowadays
causato	productivity
avvengano	inevitable
migliaia	instrument
tollerabilità	ultraperipheral
scandaloso	conduct
esprimiamo	change
gratitudine	become
limiti	write
disagi	alleviate
entrando	2003
sperar	decent
resasi	deadline
decidere	word
tutt	gap
traffico	utilisation
disporre	reiterate
deviazione	naturally
beneficiando	itemise
lasciare	pleased
presupposto	spoke
prevenzione	carry
valori	0108
sostiene	decides
area	advocating
infernale	thematic
limite	substitute
quaranta	trans
certezza	answer
immutato	laid
standard	although
permette	affects
effettuato	reflect
cambio	preparing
veramente	placed
perfetto	passes
no	extending
notevoli	pass
transitano	basic
ferrovie	methodological
costata	alternatively
tauri	exclusive
varo	bring
assiste	demographic
monti	remains
trasportati	presidency
debbono	prevails
valga	water
memori	carry
ringraziamento	commissio
vivamente	tide
impressa	frankly
rimasta	attain
ricostruzione	attracting
sud	contributing
contempla	evidence
nord	dreadful
arteria	contains
durati	properly
squisitamente	tech
vale	distinguished
pena	delay
traducono	consistency
distrutto	province
assumiamo	funding
operiamo	otherwise
andato	around
ricostruire	employed
sulll	unjustified
tante	financially
ricorderann	acceptable
alleata	hospitals
pensano	spirit
analizzandolo	witnessed
inizierò	reflected
illustrandovi	0208
tobin	appeal
considera	administrator
tassa	power
avvengono	grass
potenziare	city
circostanz	closed
destinatari	traffic
investendo	roots
università	laws
istituti	events
eldr	moral
tranne	principality
emozione	office
164	routine
garantisca	equality
patrimoniale	considered
ritirare	petersen
pongo	truth
esiga	wonder
seattle	prioritise
suscitata	utilisation
detti	badly
onda	surely
lancerebbe	unjustified
modesta	moral
apprendere	lead
mantenere	explanation
reitero	join
troppe	detail
impoverite	simple
ripetutamente	so
presenza	children
venivano	knowing
considerate	stipulated
occupato	somewhat
eliminato	dilatory
arrivati	hedkvist
opposto	hopefully
dipendevano	effort
investire	inactivity
grati	marked
cosiddetta	splendid
saremmo	enlargement
elettronica	employers
ignorato	closing
preparato	comment
tornato	eyes
laureati	recent
rimangano	decade
netta	reinforces
realizzabile	oppose
decentralizzazione	satisfying
universitaria	unanimous
contribuirebbe	facts
bilanciare	marginalisation
nascoste	thesis
desideriamo	putting
logica	faces
interviene	province
wurtz	media
elettronico	resumption
diffusione	entrenchment
facoltà	redistribution
considerarsi	bush
contributi	hesitant
tradotti	quick
concretamente	stipulates
avevate	comprise
accorta	studied
ero	funded
0108	declare
coesion	enforced
maggioreprecisione	right
0122	dealt
2127	persuades
effettuata	specify
spiacente	segni
riprendere	records
utile	linking
permettesse	dutch
ritenerlo	kilos
riporterà	specifics
normalizzazioni	meticulous
caratteristiche	exception
sollecitando	procedure
accelerati	unclear
scadenza	victims
ritrovassimo	absolute
inadeguato	1997
chiudere	administrative
dovessero	apart
approveremo	varies
giustificano	red
menzionato	emphasising
riportate	intervention
chiare	share
coerenza	hindrance
inaspettata	deprived
scheda	commandment
elettronicamente	high
deposto	implemented
contato	parallel
danneggia	hat
profondamente	linked
riconoscimento	reprieve
pubblicità	depopulation
rappresenti	whether
astenuti	monies
affronti	connected
7	addressed
legate	forcefully
166	prestigious
deploriamo	ground
cifre	brittan
ammesse	segni
grato	revenue
saprete	acknowledged
manifestato	thanking
rispetterò	issued
ovvio	sole
guardino	thing
alleviare	negotiation
premetto	006
immaginare	brought
peggiorata	approximation
ricchi	valid
ampliato	attend
ristrutturazione	solution
consistente	via
aggiungiamo	moreover
convinzione	0108
simpson	correctly
dispongono	lynne
armonizza	these
recepimento	express
realistica	drawn
discutiamo	upgrading
creati	non
averne	makes
obbligatoriamente	allocation
praticamente	appreciation
scontato	advance
acquisito	additionality
consegnato	tanks
margini	electronically
garanzie	channel
continuare	share
contenenti	delayed
menzionati	unnecessarily
importanti	pleasant
occorra	keen
limitare	advise
magnifico	latter
proficua	syndrome
rendiconti	benefited
instaurata	harmed
genera	rates
attitudinale	intention
container	criminal
mescolarlo	necessarily
costrette	sincerel
istituzion	deliberations
commission	advise
esistente	socialist
straordinaria	japan
riprende	less
aereo	fore
navi	stipulated
perfezionare	dialogue
tranquillamente	dedicating
trovarsi	reasonable
viaggiare	opportunit
meteorologiche	held
marittimo	modules
trasportavano	expectations
navigano	pm
camion	romano
coinvolti	possibilities
dichiarare	periodical
rimasti	accepts
dedicarci	compromise
tanti	combat
avvenimenti	good
margarina	deeply
50	tourism
sensibile	throwing
emerso	voting
accrescerne	mix
merce	hell
trasportata	violent
giapponesi	eaggf
pericolosa	completion
favorendo	intended
chilo	credibility
vernice	organisation
belgi	permit
condotte	matches
comportavano	determined
autentica	fairer
indagini	cofinanced
navigazione	lorries
commissari	bad
comportano	assessing
troverà	keep
attraversano	conservation
fertil	twenty
adoperarsi	reduce
crescenti	object
volumi	0106
pregare	criterion
marittima	individually
acque	grow
constatando	adjourned
19	sensible
marzo	scrutiny
regolarmente	sign
occupand	possible
benché	commissione
contare	operations
avrei	inevitable
uniformi	insularity
uguaglianza	focused
diplomi	swoboda
esami	culture
pio	chamber
minimi	completed
raggiunta	allocation
attivato	memorandums
consulenza	worse
35	relation
95	e
sancite	strongly
limiterò	drew
generi	destroyed
consapevolmente	matte
certificazioni	struck
esorto	grounds
esercitare	consultation
attenta	occurred
sorveglianza	allows
dovesse	exit
adito	methods
9002	topical
iso	characterisations
normativo	fourthly
toccato	overseas
eventualmente	suffered
provengo	ensures
assume	rates
peggiorare	criticisms
unilateralmente	layers
aziendali	relatively
leggero	yo
tempestivit	merely
proceduto	colleagues
candidati	enacting
imputato	huge
attivarci	outcome
acquis	solely
concorrenziale	rack
auspicabili	criminal
olanda	consolidate
normative	fischler
godono	foggy
scettico	evaluated
soddisfacenti	dwellers
permettetemi	tobin
occuparci	analyse
pronto	precise
rete	participate
qualora	goes
temperatura	subsequently
lavora	eighteen
effettuano	prosecutor
solito	sport
sciagure	constitutes
galleria	helped
chiudendo	meeting
incentrata	upheld
continuino	distance
lacuna	requested
veicoli	penalties
immatricolati	reminded
manutenzione	vehicle
sapendo	nos
finisca	dreaded
aggiunga	perceive
intendiamo	frequently
aerei	reach
riviste	prove
giugno	throughout
risale	officer
norvegia	outermost
londra	adult
paddington	199
modificata	whenever
evitiamo	adopts
figuri	sectoral
stazione	highlighted
mass	repair
fissato	trained
tristemente	efficiency
recente	japan
consente	received
serbatoi	route
introdotte	optimism
assicurarci	consistent
elevare	regrets
rigido	company
normativa	rise
resistenza	southern
basse	messrs
certamente	whatsoever
presi	functional
adibiti	diversification
pensato	undeveloped
venti	instruments
intervenga	properly
vivono	bureaucratic
bacino	earn
mediterraneo	thi
puntualmente	broad
applicate	laughter
emozionato	past
ancor	bradbourn
amore	unified
fortuna	broaden
durato	appreciate
minuti	4
commentare	gulf
sensi	seasonal
leggi	service
solamente	seen
aggiuntivi	through
accrescerebbe	real
irritazione	elected
recepite	renew
canto	players
deplorevole	refusing
normazione	stringent
deploro	reconsider
concerne	trumpeted
comportato	institution
fascicolo	gladly
adeguati	competition
sviluppi	damaged
paio	adopting
dipende	asking
costringe	status
inadempienze	rejected
altrui	evening
obbligherebbe	global
eventi	hit
sicuri	closely
legislative	indicative
0083	minimal
dimostrare	generated
belgio	chapeau
nebbia	planned
scorsi	shows
prodotti	sense
0104	close
0004	lived
quanti	directly
doterà	grew
guardare	satisfying
basti	unnecessary
adr	violent
armonizzati	reference
corsi	spending
indubbia	hague
validità	ever
attribuite	totally
b	subjects
emanazione	accurate
severe	stimulating
protezione	confirm
ridotti	borders
scontata	expected
bretone	potential
costa	impact
hoc	cofinanced
largo	excuse
stabilisce	constructed
petroliera	observed
emanare	protection
assistita	ministers
ecologico	intolerable
disastro	bridges
accolto	worry
legislazione	matters
restanti	different
ripreso	cut
incertezze	assume
sei	rigorous
limita	reinforce
prolungare	strengthen
rinviando	partners
industria	quoted
eliminare	equitably
ritenute	attaining
obsolete	conclusions
disciplinare	probable
qualificati	operation
motivati	lastly
altamente	forego
maniera	uniting
permettano	workable
versano	strategies
inviare	bush
peggiori	95
emerge	urgent
pericolosissima	lastly
rinnovarlo	processes
imposizione	moves
irresponsabili	man
risoluta	telecommunication
occasion	ignorance
concessa	personally
legislatur	164
arrivi	subsidiary
tardi	remoteness
collettiva	contributions
elaborati	internet
colpo	leavers
esistenti	richer
produttori	237
tenuti	islander
succedendo	suggesting
vediamo	accomplished
stia	proper
prendiamo	complementing
indicatore	expanding
coordinati	segni
verifichi	prevention
sbagliarci	austrian
parlato	markov
esplosiva	judge
calo	routine
demografico	catalogue
rinnovare	damaging
principalmente	brandenburg
vitale	portuguese
abc	writing
pubblicate	criticising
determinato	throughout
urbani	difficulties
riguardavano	lagging
riesaminata	establishes
avessero	meantime
rinnovamento	seasonal
viario	chipped
spagnolo	impose
acquee	biodiversity
reflue	holding
riferite	preparing
opinioni	setting
fissati	37
lanciare	established
compartecipe	costs
prenda	individuals
rifiutare	earlie
apparenza	constructively
burocratico	keeping
sussistano	handling
comunichi	superb
scontento	belief
scapito	procedural
estrema	answer
verificheremo	packaging
confusa	ultimate
confessarle	went
cura	elisabeth
rivitalizzare	owner
18	paddington
intera	appraisal
concentrarsi	influential
ricordando	insufficient
disuguaglianza	regretted
ribadisce	deficiencies
attori	oil
coinvolgere	delivered
sufficienza	vague
ritiene	contained
prenderne	constantly
votata	bear
delinea	nations
opponiamo	home
eccessivo	quarrel
centrali	things
rallentare	consider
svolgimento	vocational
monopolio	applause
impiegati	magnificently
proposti	lag
sfruttata	relativises
direttive	deviate
aiuto	envisages
latere	federal
scaturiti	corroborate
raccomandava	principles
risoluzione	performance
perseguiti	cos
cresciuta	followed
dismisura	assessed
spiegarlo	december
numerosissimi	purposes
dettagli	anyway
emersi	linked
conoscenza	youth
attualità	99
approdare	ratings
giacciono	visited
tenendo	lowest
quadri	initiative
proviene	obtain
esaminati	deadlines
discussi	required
presentasse	purely
elisabeth	desperately
territori	chipped
discussioni	justifying
consentendoci	structure
invertire	statistics
tendenze	sparse
innocenti	unambiguous
determinano	committed
interessante	paradoxical
sostegnoo	granting
detiene	motion
decisionali	strengthened
complessità	straight
organo	focus
investitura	reads
interessata	0120
efficienti	segni
capi	cofinancing
esplicitamente	plays
estremo	indicates
gode	gone
accettata	swoboda
consultiva	seven
subordinata	issued
impossibilità	entry
negoziale	implement
edificio	maintaining
conferito	invest
riconosciamo	brittan
aria	pre
rammarico	allowing
salire	9002
treno	ago
corsa	departments
riunito	equally
ritenere	norway
test	colleague
immediato	probably
anticipare	combat
condotto	presently
rispetta	compulsory
influenzare	repor
esaminata	appear
farsi	disadvantaged
bruxelles	attempted
edifici	ill
antincendio	ten
allude	yourself
allarme	business
giunto	municipalities
applicare	efficiently
dovranno	administrations
routine	approve
eseguire	hole
propri	decades
compiti	pleasing
fatte	wants
rispettato	ari
corrente	advice
dettaglio	neither
latitanti	author
attraversando	presidency
evocare	corresponding
ridistribuire	informal
diversamente	representing
tendenzialmente	polycentric
vorrebbero	changes
sparire	successful
accusano	seppänen
coinvolgerci	imperative
laddove	october
capaci	behaviour
dirlo	rationalisation
ripeto	luxembourg
qualvolta	press
porre	results
rimedio	greek
gorsel	orientated
raccogliere	astonished
sovvenzioni	constitutional
bastano	inspire
carenti	annex
porsi	anticipated
articolare	experiencing
sussidiarie	afford
risponderle	distances
trattare	millennium
plooj	watered
comporterà	traffic
significative	ideas
disponibile	news
geografici	compliments
reso	labour
piste	official
stessi	whereas
circolazione	publishing
capitali	summarise
sottoporre	without
importantissimo	ensured
abbienti	reiterated
organismi	competent
lynne	thousands
lasciano	blame
libera	killings
vaste	round
vergognoso	foreseeable
fumatori	analyses
riservate	free
durata	vigilance
aiutare	resumption
fumare	dealing
renderli	elsewher
vertice	appears
favorevolmente	closely
attuati	law
1989	credibility
1993	putting
gonzález	synergy
díez	reunion
consolidare	enforceable
abbandona	envisaged
irreversibili	loose
osservi	dissatisfied
operare	helping
zona	merging
euro	admit
starà	forces
espansione	unified
insulare	enjoy
discostano	message
notevole	entrepreneurial
ausilio	recommen
seguire	crust
istruzioni	outlines
enfasi	harmonisation
isolano	materials
prestata	thereby
apportate	pohjamo
strasburgo	vatanen
storia	occasion
trascina	renewable
eletto	distant
tant	reserves
continueremo	unequivocally
doverlo	table
congratulazioni	processes
età	value
divieto	paying
adulti	confirm
disaccordo	final
debbo	learn
incoraggerà	went
proseguire	infrastructures
rivolgerle	dates
dettagliata	enlighten
scale	terminating
relatori	augurs
allegato	reliable
bernié	advice
migliorie	trade
faccio	reads
ribadire	subsidiary
quinti	ongoing
eccezione	urge
acquisiscono	consuming
astensioni	2005
180	0122
ripercuote	proliferation
ostacolo	influence
422	incumbent
iscritti	initially
andarsene	substantiates
dispone	appropriately
quarti	omission
lavorano	shown
part	limited
time	contribute
efficacemente	previous
prefiggerci	entrepreneur
posta	recitals
vada	shortage
abbandoni	conceded
acconsentito	acknowledged
presenterà	harmonises
oralmente	contrary
rilasciata	equation
regolare	rejects
peso	claim
discussa	influenced
sport	regards
sanno	attaches
stagionale	beneficiaries
diversificata	guaranteeing
accentua	courts
esodo	zimeray
costituiscono	reversing
iscritt	efficiently
sorpreso	discover
biodiversità	energies
agricola	sooner
pretende	requisite
soglie	withdrawn
xxi	capita
secolo	doubt
multifunzionali	reforms
aprendosi	grow
conservazione	obligation
privilegiare	drivers
assetto	redistribute
subito	friendly
16	offices
tratterà	lasting
definire	pity
permanenza	tools
vece	ribeiro
cultura	gulf
restauro	completely
fondazione	closed
trasformazione	concentration
condivideva	extents
approfonditamente	productive
ecc	weeks
esclusivo	volatile
attendono	publicity
hänsch	accompanying
sostituiti	card
disintegrazione	0083
succedere	facing
fantasma	clearer
svolgono	meantime
biasimo	exploiting
grosso	excluding
presentarlo	storms
vostra	demonstrated
eravamo	dimension
ritenga	obstacle
trattano	opportune
distinto	destroyed
annuale	recession
impegnato	realise
parlament	unavailable
combaciano	capable
contestualmente	stimulating
oggettivo	moral
sottoporr	decisively
sperando	uniform
200	alike
pensando	competently
compensando	demonstrates
estero	assis
esorta	standardisation
veste	direct
voluto	centre
vorrebbe	inequitably
cospicua	underwater
promosso	lacking
socialisti	depend
validi	strategically
risata	lagging
energetico	livelihood
vivi	tackling
ringraziamenti	commissioner
spiegare	patience
toccherà	decisio
decide	meant
correndo	maintained
sappia	lays
minimamente	are
soggetto	unquestionably
potessimo	180
trovarci	ribeiro
rassicurare	putting
necessariamente	compilation
svista	attracting
prepararci	underspends
ripari	convinced
mandato	active
esercita	yes
ragionevole	2005
percorrere	peaceful
terrei	observations
conflitto	believes
riferiscono	reminiscent
estende	amounts
ide	statement
sussiste	unfavourable
dolorosa	expansion
carenza	managers
impressione	read
disperato	denominator
raccomandiam	seattle
egregiamente	wished
esattezza	write
campi	accidents
conosciamo	relative
collegare	prosecutor
ascoltando	macroeconomic
realizzata	grou
quinquennale	reforms
sconosciuto	currency
artificialmente	puerta
programmatico	afford
alta	november
tecnologia	feasible
notizie	299
diffuse	tanks
distribuire	entail
perdendo	unjustifiable
prim	moral
industrie	later
metodo	supervision
determinanti	vigilance
istruttivo	organisations
dice	desperately
originale	transit
tesi	needless
formalità	roots
divulgato	standard
hague	accomplished
dura	room
serve	participation
occuparsene	understand
normativi	mass
dirvi	fuster
consapevole	redondo
obblighi	findings
spostare	oral
andare	understanding
leggersi	wealthy
ambedue	occasionally
concentrassimo	validity
incrementare	acceptable
efficiente	direct
riportare	sensible
valide	cross
dicesse	constructively
rimetterle	losing
carreggiata	thirdly
investitori	prerequisites
elemento	demographic
dilemma	berlin
giudicheremo	south
pongono	recently
rappresentata	sounding
solide	originated
supporto	facing
ess	complete
appieno	envy
ratificare	raised
prosperità	barely
corroborare	needing
apparentemente	attached
sottoutilizzo	earlie
significherebbe	marked
lasciate	defending
interpretazione	additional
funzionario	nikitin
amministrazione	generally
ipotesi	21st
sostengono	kilos
leader	tide
ampie	changes
indicative	finer
assistenza	appropriately
gestori	observations
beneficiari	enactment
sfruttare	horizontal
converrebbe	achieve
dinnanzi	meaning
riflette	decade
inserendovi	negotiation
mantenga	fundamentally
redditizio	shutting
eliminazione	preparation
menzionata	entirely
scopi	dramatic
concittadini	mccarthy
convinti	chipped
rapido	products
responsabilmente	enjoyed
comportarci	list
veri	friendly
garantiscono	sec
effettivamente	appealing
piccoli	consists
nega	subjects
priori	trumpeted
formulazioni	accession
compromesso	inhabitants
valanga	azores
conosca	machine
segnalano	remit
rilevanza	operations
rivolgersi	pity
medi	strictly
scusa	lesson
portando	amount
paradossale	unclear
ritrovarci	met
puramente	reiterate
retorico	total
verità	room
creerà	round
privata	wrong
unendo	went
pubbliche	rehearsed
sinergia	consultative
completamento	benefits
comporti	strongest
chiusure	advocating
esclusioni	reluctant
impresa	upturn
dovere	mentioning
sciagurate	sceptical
riflettere	financed
conservatore	passes
permetto	models
ricordargli	livelihood
segretario	wealth
velocemente	ripple
distribuzione	changeover
sentono	attaining
emarginati	intrinsically
ripristinare	obvious
fruizione	sánchez
ricezione	influenced
avremo	petersen
rinvio	coasts
causati	figures
riuscire	compensated
superare	impoverished
scommettere	relates
energie	occasions
sottolineo	locating
avvalendosi	constructively
giustifichi	feasible
