di	</s>
</s>	that
e	</s>
che	and
la	this
in	between
il	</s>
per	to
a	and
un	and
l	this
del	and
è	to
le	to
della	</s>
non	and
i	the
delle	</s>
dei	the
dell	and
commissione	and
si	and
una	has
alla	and
con	more
al	be
onorevole	between
regioni	some
sono	and
questo	</s>
presidente	text
relazione	our
ha	than
da	</s>
anche	and
più	and
parlamento	and
signor	content
nel	with
come	would
stati	excellent
all	of
politica	this
ma	and
unione	her
mi	directive
fondi	how
se	member
gli	and
sviluppo	were
sia	also
cui	need
nella	parliament
alle	and
europea	women
linee	european
direttrici	technical
stato	which
ai	we
strutturali	the
essere	and
lavoro	work
lo	very
tale	the
quanto	rapporteur
sicurezza	</s>
modo	importance
su	can
degli	which
nelle	must
ci	and
membri	which
o	and
coesione	de
onorevoli	unemployment
questa	only
mio	more
trasporti	question
sulla	and
regionale	fund
gruppo	and
punto	and
signora	forget
europa	optimum
dal	respond
hanno	of
tutti	implementing
commissario	debate
dalla	</s>
particolare	more
nell	on
ciò	each
tutto	use
sociale	</s>
obiettivo	</s>
colleghi	come
loro	hear
molto	all
paesi	with
prima	represent
tali	tool
importante	parliament
già	states
nei	and
programmi	</s>
europeo	about
ad	with
occupazione	by
discussione	issues
agli	coordination
pertanto	involved
proposta	but
giorno	principle
sul	</s>
merci	european
sua	negotiations
solo	far
d	the
pericolose	training
fra	europe
tra	at
settore	if
vorrei	until
siamo	and
programma	remind
ho	proposals
fatto	been
importanza	the
noi	session
parte	example
quali	which
volta	aware
maggiore	and
due	have
direttiva	against
politiche	and
situazione	will
desidero	before
sulle	this
rurale	effective
trasporto	union
perché	new
alcuni	and
priorità	been
obiettivi	funds
emendamenti	members
periodo	regions
ordine	guidance
oggi	opportunity
norme	in
quando	promote
fondo	amongst
1	they
attenzione	up
lei	companies
relatrice	this
regionali	and
questione	sustainable
economica	fact
secondo	article
favore	general
sempre	energy
relatore	attention
dall	and
suo	bearing
abbiamo	and
molti	time
caso	and
parlamentari	plans
proprio	at
programmazione	sector
nostra	programme
ed	examination
conto	not
quindi	sector
occorre	and
sarebbe	of
ruolo	approach
era	road
problemi	commission
sui	whole
soprattutto	sector
cittadini	because
2000	whether
ancora	responsible
1999	rail
ultraperiferiche	always
nazionali	state
sostegno	given
può	again
tuttavia	see
aree	services
analisi	schroedter
strada	up
accordo	issue
interno	proper
misure	s
mia	this
disoccupazione	and
nostro	serious
materia	september
infine	both
competitività	also
innanzi	either
nostri	are
dato	over
merito	integrated
quale	islands
svolto	the
grande	this
soltanto	report
tema	these
invece	one
anni	their
qualità	improving
tenere	give
grado	be
meno	opportunities
collega	this
crescita	to
devono	this
dibattito	data
altro	regard
dai	parliament
sede	priorities
ne	not
imprese	which
processo	and
koch	enough
ora	agree
vita	president
posizione	more
sull	or
inoltre	position
stata	his
uno	several
quella	whose
posti	reduction
berend	of
nostre	but
esame	safety
periodica	</s>
risorse	</s>
sarà	and
deve	third
votazione	that
zone	i
altri	job
rurali	clear
sesta	questions
garantire	important
possibile	we
considerazione	better
emendamento	are
fare	us
condizioni	hope
livello	line
credo	face
tipo	certainly
fa	remote
estremamente	event
volte	the
fine	good
sociali	party
schroedter	relevant
2006	and
me	based
dire	communication
2	it
io	subject
creare	or
modifica	was
ritengo	now
risultati	application
queste	ladies
opportuno	poor
galles	out
progetti	</s>
questi	reform
dunque	least
qualche	he
ringrazio	something
rispetto	during
momento	do
dobbiamo	assistance
infatti	your
base	on
tutte	still
vista	existing
voi	eastern
presentare	employment
territorio	wealth
così	medium
de	taken
progetto	you
pare	extremely
politico	including
decisione	most
quest	possible
dello	despite
fronte	citizens
altresì	vote
possibilità	jobs
regione	structural
anno	form
negli	pleased
utilizzo	increase
generale	magnificent
purtroppo	submitted
motivo	encourage
consiglio	which
punti	making
dopo	set
tanto	partnership
domani	little
poter	way
siano	this
gestione	second
principio	average
appena	council
dalle	regional
conclusioni	measures
ambiente	seen
certo	means
spesso	look
dovrebbe	regards
venga	why
applicazione	countries
durante	more
intervento	mistaken
quello	regional
tratta	achieving
promuovere	ensure
testo	environment
migliorare	infrastructure
presentata	for
lavori	every
seconda	improving
nome	while
futuro	proposed
cen	directly
settimana	its
quattro	production
orientamenti	one
fornire	should
aumento	review
armonizzazione	behind
strutturale	and
primo	suggested
settori	indicators
nuovo	prodi
massimo	agriculture
esempio	term
tal	effect
vengono	and
cioè	wales
possa	continue
appunto	years
opportunità	national
requisiti	tell
ue	positions
osservazioni	committee
vi	conditions
responsabilità	so
piuttosto	since
realtà	respect
adesso	meeting
voto	request
bisogno	too
nuova	place
aspetto	action
allo	him
chiedo	proposal
incidenti	writing
effetti	policy
locali	improvements
avuto	really
alcune	document
sottolineare	where
intervenire	amend
turismo	affairs
senso	tabled
raggiungere	capital
ambito	spent
nonostante	same
nuovi	problem
meglio	2
richiesta	that
infrastrutture	</s>
dare	so
finanziamenti	this
economico	between
comunque	as
pari	is
necessario	1999
vari	had
maggior	proposals
strategia	guidelines
scorso	today
coloro	end
relazioni	group
abbia	creation
impegno	help
tempo	speakers
creazione	specific
presidenti	item
nuove	roads
parere	much
attività	lanka
cinque	using
prodi	up
ricordo	be
poi	between
quadro	some
debba	research
contro	manner
idea	text
piccole	our
seguito	than
efficacia	</s>
decisioni	past
interventi	life
isole	take
corso	content
conferenza	with
valutazione	would
chiaramente	excellent
grave	of
nazionale	rules
possono	point
miglioramento	her
procedura	directive
paese	how
agricoltura	member
ogni	and
trattato	were
precedente	include
regolamento	need
giovedì	parliament
data	order
possiamo	women
ricordato	european
far	technical
mentre	which
pratica	we
coordinamento	open
comune	industry
stessa	work
sottolineato	very
detto	view
privato	rapporteur
prossimo	</s>
riforma	importance
attuazione	can
nonché	which
strumento	must
partenariato	long
va	granted
febbraio	follow
oppure	de
autorità	</s>
discutere	only
povere	more
parola	question
necessità	any
europei	fund
numero	oral
luogo	community
sue	forget
preme	optimum
chiedere	respond
potuto	of
ringraziare	implementing
certa	debate
disposizioni	</s>
dati	more
cosa	generally
stiamo	each
presentato	use
aspetti	practical
visto	types
servizi	come
sufficientemente	hear
congratularmi	all
passato	adopted
deputati	represent
promozione	tool
società	parliament
ripresa	states
maggiormente	want
necessaria	revision
dovremmo	about
intenzione	with
ricordare	by
causa	issues
mercato	coordination
finanziario	involved
contenuto	market
mezzi	principle
gravi	provisions
assicurare	draw
minime	negotiations
tengo	far
consulenti	recently
ritardo	training
luce	europe
particolarmente	at
verbale	if
gran	until
fase	having
successo	remind
formulare	proposals
poiché	been
terzo	the
attualmente	session
attiene	example
partito	etc
riferimento	aware
efficace	off
motivi	demand
medie	against
conclusione	safe
farlo	will
permettere	before
gruppi	this
sostenibile	effective
mai	union
discusso	new
possano	evans
metà	been
senza	funds
verso	members
giovani	regions
formazione	guidance
invito	opportunity
contesto	in
però	promote
conformemente	amongst
pubblico	they
principali	up
misura	companies
evans	type
pil	and
termini	sustainable
presente	fact
ampliamento	article
sapere	general
posso	energy
diversi	attention
nuovamente	strategic
riguardo	bearing
donne	tax
né	time
lettera	implementation
intendo	plans
articolo	at
ragione	sector
chiesto	programme
centrale	examination
relativa	not
adottate	private
proposito	might
vero	10
locale	approach
problema	road
competenze	commission
ultimi	whole
tre	year
c	because
rafforzare	whether
ppe	responsible
avrà	rail
erano	always
ritardi	state
persone	given
stesso	again
esso	see
essenziale	services
relative	schroedter
vigore	note
spero	issue
carattere	proper
legislatura	s
finanziamento	treaty
convergenza	problems
sfida	serious
brevemente	september
differenze	both
proprie	presented
iniziative	either
gennaio	are
conseguenza	over
urbano	integrated
presentati	islands
nello	concerned
comunicazione	consideration
ben	report
iniziativa	these
revisione	one
assolutamente	their
mesi	improving
prendere	give
attraverso	be
approvazione	opportunities
evoluzione	commitment
regole	disgraceful
avviso	reasons
osservazione	data
aula	regard
controllo	parliament
buona	priorities
insulari	not
contiene	which
ferrovia	disasters
opinione	enough
plenaria	agree
voti	president
gradi	five
qui	characterised
interesse	position
votare	his
tenuto	several
soffermarmi	whose
fiducia	reduction
termine	actually
significa	but
esse	safety
burocrazia	reference
finora	large
conseguenze	mr
affinché	third
troppo	that
politici	i
investimenti	job
popolazione	clear
prescindere	questions
direzione	important
rilevare	structurally
progressi	better
comunitarie	are
sviluppate	us
valutare	hope
provenienti	line
uso	face
tornata	certainly
varie	remote
presentate	event
riferisco	personal
state	good
documento	party
riflessione	relevant
indubbiamente	period
percento	based
titolo	communication
miei	it
prossimi	subject
economie	or
º	was
economiche	now
raccomandazioni	application
risposta	ladies
sarebbero	poor
insieme	out
ricerca	points
fonti	reform
tutta	least
viene	he
po	something
migliore	during
austria	do
ormai	assistance
formulato	your
atto	on
naturalmente	still
economia	existing
aspettiamo	eastern
responsabile	employment
abitante	wealth
perfettamente	medium
riguarda	taken
forte	you
indicatori	extremely
fatti	including
elaborazione	most
difficile	possible
sì	despite
rispondere	citizens
flessibilità	vote
finalmente	jobs
paragrafo	structural
dichiarazione	form
via	pleased
transito	increase
poco	magnificent
c5	submitted
buone	encourage
ritenuto	plenary
parlando	making
legislativo	set
prescrizioni	partnership
incidente	little
capacità	way
ricche	day
ottimale	second
indicare	average
adeguata	council
concernente	ago
appoggio	measures
tecnologie	seen
ridurre	means
insistito	look
seduta	regards
aiuti	why
contributo	countries
argomento	therefore
applicabili	mistaken
mettere	regional
costruire	achieving
pesca	ensure
fondamentali	environment
chiusa	immediately
confronti	ppe
saranno	every
barón	improving
adeguate	while
ce	proposed
trovare	directly
approvate	its
vicepresidente	production
agricole	one
sufficiente	should
concludendo	review
personale	behind
procedere	improvement
domanda	make
equilibrio	indicators
navigabili	prodi
vie	wednesday
migliori	term
piani	effect
parlamentare	recommendations
generali	wales
sforzo	continue
dimenticare	years
presentazione	national
sforzi	tell
so	positions
informazione	committee
evitare	conditions
tunnel	so
aver	since
impatto	respect
palacio	</s>
fini	request
accogliere	too
partecipare	place
disparità	action
altrettanto	him
settembre	proposal
industriale	writing
recentemente	policy
dimostrato	improvements
specifiche	really
comitato	document
orientale	where
ecco	amend
dovrà	affairs
europee	tabled
ovvero	capital
eletti	spent
negoziati	same
voglio	problem
linea	2
sottolinea	islands
casi	go
maggioranza	used
governo	this
periferiche	</s>
istituzioni	down
avevo	is
consiste	1999
azione	provide
colpite	proposals
minuto	degree
avanzare	today
reddito	end
urgente	group
rappresentanti	account
previsto	necessary
ravvicinamento	sector
dubbio	further
addirittura	into
criteri	policies
proposto	madam
ulteriormente	lanka
rischio	both
reti	more
comunitari	be
rappresenta	between
com	representatives
analizzare	four
socialismo	manner
serie	text
tecnico	overcome
espresso	than
resta	eu
chiediamo	created
altra	2000
stanno	peripheral
seri	content
imprenditorialità	with
abbiano	research
agricolo	excellent
utilità	standards
collaborazione	just
passo	each
strategico	her
carico	directive
resto	behalf
reca	hi
affari	familiar
a5	hänsch
devo	brainpower
relativi	need
vengano	guarantee
livelli	less
proposte	message
temperature	cannot
eccellente	technical
intervenuti	matter
disposizione	objective
socialista	open
potenziale	working
ridotta	conclusion
15	speak
realizzazione	a
proponiamo	that
entro	poverty
aziende	together
intesa	can
attirare	authorities
divario	pointed
interne	dimension
comunità	spillage
povertà	appropriate
finanziari	by
20	could
davvero	eu
competente	remember
poveri	groun
soluzione	any
dimostra	fund
britannico	upon
grazie	claim
questioni	light
addizionalità	smaller
occasione	respond
desidera	of
coinvolgimento	180
territoriale	needed
uniti	adult
preoccupazioni	stage
spese	guarantees
trasparente	broaden
esecuzione	</s>
personalmente	developed
istruzione	harmonisation
francese	come
mancanza	activities
poettering	all
ricchezza	required
unito	facts
stesse	tool
riduzione	get
rassicurarvi	legislation
qualsiasi	want
anch	wee
piacere	cocilovo
sollevare	even
obiezione	by
regno	technologies
modificato	yes
citato	information
sicuramente	any
legislativa	exclusion
decentrato	seem
piano	the
modifiche	explained
assai	quota
potenziamento	recently
entrata	training
offrire	analysis
partire	than
breve	competition
incremento	until
porti	having
massima	remind
catastrofe	ruling
considerare	longer
strade	years
dovuto	session
desiderio	otherwise
1200	etc
55	appropriate
silenzio	elimination
accolti	calls
1997	find
tempeste	partly
tecnologico	will
svolgere	object
intervengo	this
rendere	effective
suddetta	wrote
comporterebbe	new
costi	light
procedure	been
sri	create
risulta	ensured
lanka	regions
riguardano	railways
collegio	opportunity
futuri	in
organizzazione	promote
statistiche	specific
pur	ongoing
soddisfare	recent
suddetti	growth
considerazioni	berlin
rischi	laid
fruteau	sustainable
risalto	halfway
lentezza	step
tempestivamente	leaving
verificati	internet
vantaggio	continuing
millennio	strategic
mezzo	bearing
essi	youth
germania	initiative
italia	enforceable
accettare	prepare
colpiti	their
catastrofi	that
naturali	strategies
unico	workers
relativo	higher
dove	project
qualcosa	unanimously
chiamati	floor
compiuti	words
provocato	road
propone	programmes
funzionamento	5
dipartimenti	areas
ampiamente	because
francesi	whether
vatanen	innovative
avere	any
preparazione	mathies
flessibili	efforts
accade	used
dovuti	operation
fossero	within
sullo	funded
orientamento	particularly
preso	up
suoi	lower
consulente	austria
dimensione	reason
introdurre	is
cose	learn
sezione	serious
evocato	september
potrà	closing
concludere	presented
correttamente	present
capitolo	by
pienamente	briefly
erika	integrated
numerosi	managing
compito	industries
maggio	frameworks
approvati	signed
ferroviario	institutions
media	speech
trasparenza	analyse
congratulo	seek
mese	supported
inferiore	she
assistere	account
sotto	reducing
esprimere	sector
ultimo	reasons
carenze	worth
altre	1
ulteriore	ways
constatazione	thus
buon	feared
ammettere	proposals
dagli	situation
socioeconomica	proceeding
potere	the
giungere	advisors
trovato	united
atti	characterised
situazioni	repeat
1998	formulas
agricoltori	raising
ultima	millennium
patrimonio	ripple
condizione	introducing
città	but
alcun	excessive
inserito	slowly
crespo	people
approva	understands
dando	bear
posto	being
sperequazioni	levels
serio	socialists
disponibilità	improve
forse	questions
positivo	3
spirito	officials
mercoledì	better
tutela	people
questori	us
tenute	southern
potrebbe	line
rivedere	face
debbano	abreast
chiaro	remote
sfide	relate
esperienza	applied
diritto	reached
consentito	party
vuole	given
presa	efficient
almeno	tunnels
embargo	which
esiste	technological
avanti	subject
adottato	or
perdita	and
entrare	palacio
indonesia	populations
codice	ladies
considerato	poor
diversa	422
appello	personal
poche	agrees
25	depth
geografica	at
aggiunte	for
vedere	minute
votato	do
dovrebbero	purposes
mondo	land
strumenti	on
luglio	still
orario	challenges
olandese	eastern
globalizzazione	doing
avrò	differences
ricevuto	medium
volti	develop
denaro	discussed
riusciremo	hatzidakis
disposta	achieved
deboli	most
disponibili	directives
chiave	certain
rapidamente	transport
intermedia	vote
membro	process
fuori	structural
ottima	thi
contribuire	pleased
finanziati	impact
altrimenti	funds
riunione	palacio
amministrativa	more
passare	course
approvata	making
disuguaglianze	set
definitiva	partnership
temi	little
van	way
discorso	day
prodotto	second
noto	average
governi	council
tratti	ago
essenziali	measures
wulf	seen
mathies	the
avrebbe	effort
spetta	more
avrebbero	parliament
stampa	negotiations
sostenere	therefore
nota	a
trattamento	start
concluso	equal
adeguatamente	at
omissione	once
sistema	germany
occupazionali	requirements
principi	effort
dichiarazioni	improving
lotta	while
avevamo	there
energia	0105
sostenuto	its
ottenuto	sources
lungo	smes
pronti	stage
distanza	storms
speriamo	justifying
disoccupati	improvement
bene	months
rinnovabili	attentive
realizzare	regions
quel	no
vogliamo	procedure
sta	effect
hatzidakis	affected
conformità	send
nesso	outermost
verificare	instrument
struttura	entails
completamente	tell
spesa	procedures
imposta	economies
grandi	proposal
sviluppare	still
costituisce	assist
continua	respect
rappresentano	offer
giovanile	request
definizione	speeches
rilievo	place
inserire	prioritise
amsterdam	him
periferici	later
cuore	writing
troviamo	shortly
vigente	preaching
bensì	really
bisogni	schemes
ovviamente	ships
comprese	stressed
istituire	business
normalizzazione	parliamentary
terreno	capital
cospicui	did
inutili	attaining
orientata	adapt
permanente	early
rivestono	reasonable
ovviare	comes
modificare	alike
connesse	producers
imprenditore	united
sistemi	peripheral
convinto	express
inequivocabile	richest
penso	aided
precedenti	sánchez
esperti	observation
modalità	july
contribuito	maintained
esercizio	upgrading
inseriti	undertaken
sperati	someone
comitatologia	messrs
tempi	approved
processi	equitably
indicazioni	review
logico	exile
sudre	linking
desidererei	administrations
complesso	phase
negativa	fischler
formulati	between
ascoltato	tunnel
ciascuno	299
scuola	not
scadenze	dictates
continuerà	sustainability
trattandosi	sufficient
raggiunge	seminar
seguenti	drafte
ottenere	followed
berlino	tool
necessari	eurostat
quantitativi	chairmen
definito	led
essa	meticulous
globalmente	prevent
accompagnamento	head
1994	competitive
quarto	solely
finanziare	harmed
sussidiarietà	earlier
maggiori	many
affidabilità	domestic
includere	competent
centri	º
swoboda	irresponsible
condotta	establish
richiede	air
sé	answer
strategica	treaties
impone	stipulates
competenza	improvements
prospere	properly
merita	provisions
frutti	role
rapporti	balance
mccarthy	increasing
sostanzialmente	days
diverse	enforcement
associo	businesspeople
infrastrutturali	underspends
svezia	point
lordo	boosting
tipi	sitting
produrre	or
concorrenza	knows
approccio	will
produttività	differently
avanzata	integration
apprezzamento	only
integrato	more
158	february
attribuita	finland
scarsa	insignificant
occupazionale	proceed
giustamente	placed
terremo	norway
rack	observance
attribuire	resistance
occorrerà	takes
regolamentazione	perhaps
dichiarato	towns
evidenziare	structure
integrata	rather
strategie	directive
integrate	each
urbane	public
2003	practical
legislazioni	rebuild
aumentare	redevelopment
lunga	used
successiva	inevitable
funzionari	mention
transitorie	changes
fervore	enforceable
rendimento	twofold
esigere	stand
sviluppati	unacceptably
caratterizzato	request
eccessiva	ones
sarò	be
pubblici	fields
dam	internal
allegati	establishing
tuttora	interregional
prova	delays
dedicata	financial
principale	0208
approfondito	satisfy
dovremo	specify
prioritario	friendly
dirmi	productivity
elevati	has
lavoriamo	here
fatta	broke
fanno	differentiating
delineare	added
incentivi	relevant
svolgerà	getting
chi	has
equamente	gladly
199	income
lanciato	labour
94	example
giusta	shutting
giudizio	simply
negative	while
predecessore	prosperous
difficoltà	subsidies
segnalati	spoke
indica	eighteen
continuiamo	sometimes
documenti	voting
talune	towns
citarli	thanks
adotterà	full
commenti	engaged
vostre	development
suggerimenti	find
partenza	reality
concreti	inevitable
intese	strictly
prese	issues
cos	refers
en	reconsider
raggiungimento	mccarthy
richieste	accurate
vuoi	must
concentrare	become
sembrare	decisive
intensità	themselves
pilastri	ready
10	planning
qual	fund
là	with
feaog	eaggf
fornisce	sorely
spazio	wished
esclusivamente	desired
urbana	south
negativamente	hat
impiego	waterways
trovano	criteria
valenza	depopulation
utili	zone
evidenti	inhabitants
rappresento	examination
offerta	materialise
richiesto	unemploymen
seno	where
tener	closely
diversità	enjoyed
crescente	here
zero	cofinanced
comunicazioni	deletes
accettiamo	records
circostanze	transit
talvolta	rapidly
condannano	mandate
pubblicazione	explained
impulso	worthwhile
tramite	protect
forza	sense
nn	matters
sugli	real
umane	alexander
flautre	pleasing
insufficienti	chairmanship
comprensione	taxation
fosse	is
energetiche	determined
memoranda	bernié
scrive	globalisation
avremmo	earned
esigenze	decreased
quasi	trumpeted
abitanti	group
auspicato	attitude
origine	deprived
sfavorite	dam
legato	advance
produzione	examined
terziario	sides
commercio	offers
anzi	accident
atteggiamento	occasional
registra	catastrophic
campo	lankan
cerca	resolutions
status	coming
affrontare	studied
costruttivo	passionately
lieto	times
esclusione	re
criterio	compulsory
tessuto	chapter
crescendo	needs
fin	statistics
propria	relating
enormi	envisaged
taluni	firmly
prioritari	along
tenga	located
quelle	ad
capitale	concerning
adeguato	appealing
richiedono	immediate
critiche	in
intollerabile	decisio
pianificazione	able
lapponia	pse
passata	businesses
inevitabili	explanations
sec	transparency
elementi	effectiveness
clima	regions
nordiche	cos
proporre	petition
alto	reserves
contribuenti	benefit
starebbe	distances
identificare	nuisance
recupero	understood
costretti	initiated
avvio	ability
auspicio	intended
garanzia	here
ampia	taking
fattispecie	refuse
suggerisco	sincerely
violato	resulting
prospettiva	appraisal
basta	fight
trattiamo	just
cambiamenti	successfully
amministrazioni	laid
utilizzati	mr
reale	taken
stabilire	factor
cisterne	useful
chiarezza	barón
vedremo	me
299	directive
prossima	including
opera	capabilities
patti	red
strutturalmente	units
settentrionale	prepared
consentire	monetary
vasta	cost
territoriali	visit
specialmente	for
illustra	spending
ambiti	flexibility
compreso	show
costruzione	exclusive
specifici	harmful
operato	fore
offra	rural
bilancio	appear
succede	seattle
vanno	entails
settimane	vice
lunghe	education
riconosciuto	young
dialogo	suggests
preparare	mass
quelli	luxembourg
marea	berend
riprese	november
necessitano	say
dovuta	detail
francia	lesson
facendo	cargo
celerità	rather
materiali	frost
savary	whereas
vigile	specifics
competitive	human
coerente	called
elevate	territorial
evidente	stand
prevedere	submitted
indispensabile	potential
limito	consider
messe	place
dimenticato	koch
tocca	although
sinergie	transported
partecipazione	stretched
portata	present
conseguire	basically
dico	corresponding
imprenditori	spillage
creatori	assis
pratiche	forward
riteniamo	dared
conseguimento	initiated
imprimere	thinking
intero	overall
permesso	country
america	priority
scala	rail
rende	earn
progressiva	size
positiva	creates
inutile	throughout
nera	often
terza	small
parlare	happening
freddo	mentio
contempo	affected
possibili	excluding
34	criticisms
presidenza	pronounced
armi	however
risultato	fisheries
favorevole	17
ricordano	nevertheless
responsabili	itself
proporzioni	december
lato	statement
stragrande	response
segnale	usefulness
intende	sparse
corretto	reminded
certi	polycentric
visita	offices
giovane	schools
novembre	wales
dieci	accepted
centro	renewal
intervenuto	our
rilasciare	others
sarei	logical
gravità	assume
innumerevoli	did
lui	conclude
auspica	away
messaggio	retained
lettura	involving
perciò	industry
scors	view
odierna	consists
terribile	paradoxical
esito	monitoring
aveva	reached
perso	catalogue
annunciato	useless
comportamento	appear
stradali	subsequently
ferroviari	traditional
internazionale	therefore
determinate	back
pubblica	insularity
texas	dangerous
vigenti	castro
dedicare	fellow
fallimento	accordance
relativamente	assure
interrogazioni	make
orale	initiatives
prego	go
interrogazione	half
constatare	bound
apertura	highlights
coraggio	annual
verificatisi	expectations
testi	worrying
basa	provide
morte	part
favorevoli	degree
condannato	earlie
interessati	promoting
precedenza	lead
esprimersi	account
presto	watered
inserite	uk
competenti	rigorous
preciso	158
applausi	notice
giornale	may
beneficiato	has
parla	stern
banchi	live
interruzione	originally
enorme	changes
concordato	representatives
considerando	maximum
piedi	manner
9	matte
potremmo	overcome
navigabile	reluctant
internet	inequality
iscritto	if
assolto	aware
allora	over
consentirci	shores
ascoltare	existing
accesso	renewable
riserve	marginalised
elaborare	enterprises
accetto	military
richiamare	paragraph
oltre	her
rinunciare	somewhat
volentieri	behalf
piccolo	meet
insufficiente	familiar
conforme	historic
sciagura	brainpower
essendo	laws
abbattute	ppe
danni	high
esaminare	distributed
accordi	in
sentire	body
ossia	alternatively
alexander	regions
cod	enforcement
nikitin	shifting
hnsch	conclusion
accontentarci	dimension
unanimità	hard
inizialmente	everything
sottoscritto	diversity
posizioni	reading
recenti	myself
cox	safer
sappiamo	stands
alcuna	sri
profitto	see
trarne	central
dover	friday
denunciare	unfortunately
dispiace	they
colmare	remember
iniziale	contained
occhi	promotion
vittime	more
comuni	upon
implica	scant
insediamento	requirements
informazioni	in
attuale	requisite
presso	be
siete	laughter
trattati	feel
diretti	unified
istituzione	force
genere	guarantees
osservare	portuguese
evidentemente	basis
ribadito	states
potranno	stressed
verrà	money
faccia	influential
sufficienti	abroad
respinge	concept
prove	facts
contrari	15
canali	difficult
quei	grounds
dicembre	cut
incendio	forcefully
chiede	cocilovo
decisamente	anything
oggetto	committed
fondamentale	french
mie	are
romano	everyone
manca	course
pensiamo	economies
morale	distribution
ciascun	improved
gestire	explained
rientra	consolidate
ritirato	played
semplice	criteria
suddetto	gesture
canale	job
nutre	regions
ribadisco	suffered
sessione	implemented
affermare	remind
preferito	thank
rinnovo	almost
pone	comprehensive
esistono	couple
adesione	cunha
complimenti	dangerous
venisse	different
gradirei	disbursement
norma	calls
permetta	prime
esattamente	debated
espressa	violent
17	ari
aumentato	lessons
salute	lack
contrario	educational
integrare	new
rispettiamo	refusing
finlandesi	memory
quinquennio	correctly
rallegro	definition
corretta	causes
funzioni	strong
stabilito	stringent
aderiranno	france
sento	ease
annuali	them
2001	decentralised
disposti	never
egli	growth
rigorosi	company
deciso	tampere
eventuali	conversion
illustri	easier
concordi	20
rispettare	already
mancato	internet
assemblea	continuing
sebbene	observe
figura	disparities
comunitario	hours
paiono	reminded
uffici	handicapped
faremo	prepare
fino	and
ebbene	seriously
cada	cornerstones
avvia	workers
tardivamente	initial
consultato	earn
primis	unanimously
carica	floor
angelilli	40
rispettivi	dreaded
3	commandment
costantemente	employ
formulate	motion
prestigio	moves
richiamati	amended
ciascuna	list
giusto	valid
comunitaria	materials
dibattute	concluded
egualmente	declare
giustifica	operation
esige	scale
cofinanziamento	funded
collegamenti	highlighted
spetti	dealing
realmente	vote
settennio	austria
iniziati	proportion
membr	interesting
delicato	tailor
rivolto	exception
opportunamente	ideas
orientare	reinforce
sospendere	hesitant
condanna	drafte
sens	whenever
giuridico	briefly
assegnazione	completely
attribuisca	55
divenire	industries
stabilità	definite
legga	japan
graziare	agreements
permane	full
aumenta	tankers
delineato	seek
godere	beneficiaries
segni	rejection
precisi	wait
farò	deprived
flotte	decade
intersettoriali	funding
eccessive	unanimously
facilitare	severely
sovvertirlo	festive
tiene	absolutely
monica	forget
attim	sorry
tornerò	situation
scadenz	proceeding
consapevoli	representations
governatore	advisors
attentamente	nikitin
affidabile	characterised
ritenuta	repeat
destinata	observed
caratterizzata	convenient
rafforzata	met
imminenza	ripple
europ	introducing
grech	contribution
salvaguardia	week
elezioni	bridges
intraprendere	35
presentandomi	commerce
acquisisce	tread
ambientale	equality
bush	levels
aspettative	wider
rafforzamento	transportation
sostengo	attached
quell	investment
ministro	agreement
gerarchico	transpired
costituito	shortcomings
voler	innocent
uomini	contributing
lungi	final
monetaria	needless
puerta	lays
espresse	around
riconversione	italy
sostenibili	dwellers
attribuiscono	koch
madera	opinions
altezza	scenario
redigere	efficient
supplementare	temporary
chance	procedural
23	yourselves
incontro	productivity
preoccupazione	identify
partecipato	deadline
spiegazione	somewhat
apparente	populations
semmai	coherence
velocità	media
inaccettabile	granting
particolar	handling
personalment	step
servizio	nikitin
umana	incorporate
ingiustificabile	spring
rimane	gap
diseredate	necessarily
scarto	purposes
relatric	fell
coincidenza	fourth
pregiudiziale	backward
sventare	treat
alibi	coinciding
osserv	conservative
bei	inspire
quartieri	according
periferie	develop
equilibrata	north
contemplano	accompanying
orizzontali	location
constata	capable
rivolgendomi	beginnin
fissata	late
valorizzando	subordinate
includo	wulf
tematiche	read
leva	efficiently
petizione	criterion
passione	remembered
strategiche	whom
intelligenze	low
inammissibile	admit
intorno	compliments
socioeducativi	frequently
associazioni	factor
articolano	multiannual
vostro	wurtz
forme	2007
firmatari	obstacle
affermato	brussels
seppänen	second
parlo	9002
giuridicamente	particula
propriamente	representative
prestazioni	measures
riserva	chiefly
bradbourn	minds
ricorso	devote
indirizzo	presentation
contribuiscano	allocation
attuali	reflect
raccolte	employees
partenariat	constructed
chiameremo	represented
espressamente	absolute
pagina	delay
5	once
hicks	adopt
proroga	mathies
scritto	governing
ricordar	legally
sollecitat	thesis
interpellato	inasmuch
siffatto	elected
castro	month
ribeiro	mainland
esperienze	smes
deputato	81
potrei	chipped
lontane	justifying
lontananza	prosperity
zimeray	person
attivo	attentive
trattasse	consistency
poterlo	principal
sincerit	wish
aggiungo	issued
duraturi	corroborate
solidi	wales
inevitabilmente	balanced
reperire	instrument
redditività	react
concessione	moment
scroedter	extents
ingenti	perspective
somme	sec
risoluzioni	running
inizio	com
esborsi	envisages
vaghi	offer
interrompere	tobin
rivelatosi	sorely
chiedono	available
attuabili	carry
cosicché	agricultural
assunta	supervision
correnti	applause
guida	investments
definiti	disregards
solida	ultimate
farle	romano
sostanziali	assessment
togliere	treatment
renderla	speaking
pertinente	parliamentary
servire	reliability
riversate	feeling
illustrare	attaining
ragionamento	feet
utilizzate	drew
esposta	tourism
insegna	separates
esaminerò	nos
probità	creation
finanziaria	exchange
inutilmente	section
barents	preparation
benefici	texts
farà	condemned
mare	extent
contrastando	witnessed
ricerche	ensures
tentazione	depend
tirare	relations
controllare	generated
continuando	indeed
assorbire	amendments
soldi	accomplished
localizzati	responsible
darà	responsibility
appoggerà	parallel
illustrato	changeover
storici	ghost
esborso	6
contribuente	also
sindrome	hop
russe	mentioning
spendere	burden
portare	16
cambino	unless
metodi	enforced
usati	prerequisites
buono	redistribute
introdurrà	opinions
indicati	periodic
realismo	quotation
cambiato	acceptable
bozza	makes
mirano	awaited
difficili	reflected
tenuta	relate
consentirebbe	joint
alimentare	adopting
destinati	revitalise
spediti	irresponsible
veniamo	giving
armonizzare	severely
previdenza	inequitably
olandesi	arrangements
unificata	indicated
vago	1993
ridà	ide
compiendo	loud
voteremo	periodical
complimentare	principality
ottimo	total
est	listening
precise	azores
protesa	communautaire
problematica	stipulated
rafforza	decisions
dilagare	treason
ineguaglianze	hit
scenario	portugal
plausibile	spirit
approfondirsi	seppänen
frenare	definitions
rilancio	supports
telegiornale	employers
mira	lesser
gradiremmo	preferred
mensile	plays
realizzarlo	dramatic
estendere	trans
esilio	effect
ridistribuzione	protecting
cauti	distinguished
potermi	savary
alzare	living
fede	genuinely
west	appropriations
midlands	fill
riservati	amounts
stasera	sensible
lampante	2007
stregua	7
partorire	channels
idee	friendly
grandiose	judge
prive	treat
consistenza	impression
rivelano	often
immediatamente	financing
intento	holding
scarso	adult
portoghese	pity
enormemente	favour
utilizzare	recommen
potenzialità	appropriation
intenzioni	firm
dia	modules
impegni	youth
carente	escape
costituiti	persons
operatori	2003
economici	liked
concludo	lacking
dicendo	publishing
riservata	seven
televisivi	implementing
femminile	via
concernenti	secondly
sancito	thought
preoccupano	humanist
voci	personally
scemando	substantial
pensare	ultimate
trova	loud
espressi	significance
vorremmo	ability
imprescindibile	probity
azzorre	attend
monetari	lankan
colgo	profile
spiegarci	inactivity
ragioni	half
attende	repair
russia	know
ribadendo	sooner
segnano	protecting
risibile	thirdly
inesistente	born
messo	protection
desolazione	table
attuate	zero
vasti	d
strati	synergies
repressive	react
contrariamente	denominator
cambiamento	judge
rotta	criticising
nulla	alone
lascia	additions
ipotizzare	rationalisation
cambiare	righ
costituzione	pre
visione	consuming
uomo	examinations
appartengo	affects
volto	importantl
inserisse	listen
positive	results
segue	supplements
unanime	influence
operano	stop
parità	taking
innovativi	unjustifiable
donna	sources
rivestiva	storms
trascurato	soon
molteplici	framework
stiano	movement
aiutando	23
meravigliosamente	seems
arretrate	concentration
lieti	highlight
pretesa	organisation
catalogo	reading
originario	unilaterally
condivido	lag
procedano	nations
semplificazione	scenario
sottoscrivo	benefit
tribunale	elsewher
colossali	midlands
elevata	consistently
manodopera	subsidiarity
fissando	valuable
chiari	periodical
alternative	attempted
ivi	root
compresi	appropriations
beneficio	correct
consenta	endorse
intelligenza	forces
giudiziario	colleague
efficaci	permanent
risultano	grou
visibili	prosecutor
cittadino	vague
trae	0107
errore	harmed
semplicemente	supervisory
mano	check
diretto	commandment
neppure	dreadful
prestare	additional
risoluzion	truly
scontrano	whilst
ostacoli	finnish
completo	horizontal
assistenz	practice
finanziariamente	three
sostenibil	press
dignitoso	limited
criminali	proposal
elemosina	destroyed
reati	hitherto
spinta	believ
ponti	moor
v	subsidiary
rappresentino	monitor
atte	financially
commesso	supply
restano	backed
accusare	twenty
inammissibilmente	conduct
assicurarne	incumbent
approfondiscono	advances
colossale	suggests
massa	laws
attenuata	highly
aggravata	marked
ricorrerà	insurance
irrimediabile	january
drammatiche	grow
meridione	badly
parole	presentl
pericolosamente	amendmen
soffermarsi	approving
contenuti	sufficiently
ministero	consists
accusa	volatile
rendersi	enforcement
accelerazione	wants
registrata	districts
mutare	paid
scavare	degrees
sottomarini	layers
collegarle	acquis
continente	minor
onde	heard
potersi	fifth
adattare	neither
agevolmente	evidence
separa	supervisory
potendo	figures
comportate	bomb
avvento	intention
auguriamo	initially
numerose	putting
dinanzi	rise
inquietudine	allows
lavorare	annexes
subordinato	matched
dipendente	avalanche
equa	0122
provengono	minister
umili	utilising
figli	drafting
svilupparsi	amendmen
positivamente	eaggf
cercano	condemned
lavoratore	attach
aggiungere	safe
imparare	blame
operosità	acquitted
moda	combat
indice	century
invidia	telecommunication
avendo	broadly
manciata	belgium
ospedali	consequently
gente	essentially
reagisce	intervention
andando	departments
guadagnarsi	relates
pane	governor
altrove	pulled
medesimo	bradbourn
scuole	charged
secondi	loose
costoso	knowing
vivere	addressed
desse	aptitude
terribili	growing
incentivare	renewal
proprietà	hell
azienda	heart
nutrirlo	tech
fiscalità	advisers
dapprima	becaus
rinviato	delivered
prime	solution
riflessioni	enable
inducono	building
ottimismo	conclude
lancio	initial
solenne	genuine
tradurre	becoming
difesa	opportune
produzioni	zoning
tradizionali	products
concrete	disappearing
audaci	old
ambiziose	done
resteranno	associations
morta	six
tasso	above
andrò	communications
dritto	flexibilisation
materializzato	affected
baco	environmental
distribuiti	demonstrated
duramente	intending
drammatici	starting
isola	unfavourable
abissali	gross
37	pose
congiunturale	strengthening
insularità	users
personalità	willingness
determinare	hedkvist
farvi	9
specifico	region
derogatorio	coup
aumentate	raise
sensato	seven
spostando	ar
accento	numerous
svariati	includes
frattempo	transition
giunge	attach
prefissati	hesitant
raggiunti	messrs
lasci	flexibly
essersi	via
ridotte	steps
omogeneità	discontent
calato	capita
irrisoria	ongoing
persino	global
dipenda	basic
inefficienza	methods
aumentano	capacities
soddisfacente	wonder
quantomeno	successful
nemmeno	199
degni	went
riluttanza	note
giustificata	migration
dubbi	historical
sorgono	anticipated
sommarsi	simpson
sembra	climatic
parliamo	exists
conoscono	cooperation
rientrano	legal
memoria	ask
interessate	whatsoever
concedendo	resulted
concordo	resumed
lì	drive
quotidiana	commitment
credibilità	uniform
sostenut	love
oserei	commissio
mirabilment	e
portogallo	enter
grecia	accession
gareggiato	financed
influisce	hopefully
venticinque	kinds
direbbe	owing
coup	inherent
chapeau	careful
cappello	comitology
avete	absent
nazione	obtaining
rimangono	repea
rimproverato	pose
giorni	auditing
chiedersi	strategy
criticamente	flautre
perseguita	ex
innalzamento	principality
presupposti	monetary
riforme	documents
fiscale	alike
traduca	producers
perseguire	hence
riesce	intensive
durevoli	delegating
tenesse	costs
riesca	buildings
quota	sánchez
riduca	certificates
significativa	entry
fusione	temptation
guidata	upgrading
fischler	remain
assicurarvi	rejects
sforzerà	messrs
interrotta	thorough
presterà	equitably
andrebbero	deserves
soffermato	probably
capo	linking
periodiche	administrations
comportare	faces
rigoroso	quarters
dichiaro	recommended
stimolare	prove
raccolta	incentives
rappresentativi	dealt
richiamato	wishes
interessa	affect
venerdì	law
cocilovo	approving
ripresi	past
inchieste	leader
eurostat	losing
aparicio	behaviour
sánchez	amending
mancata	contribute
oriental	renewables
dimensioni	told
limitate	stagnation
settor	favour
affatto	reprieve
trascurabil	c
concentrazione	earlier
ristretto	personality
facilita	intentioned
integrazione	competent
ottenuta	purpose
nogueira	hold
román	establish
ritengono	complete
rimanga	answer
punt	shipment
apporto	struck
molte	revenue
decennio	greater
umanista	involve
profila	service
primi	explicitly
preadesione	uniting
sspa	angelilli
prossime	modernisation
vedete	russia
sinceramente	discussion
franchezza	matches
ann	functional
transfrontalieri	poorest
sforzerò	missed
attenermi	knows
note	additional
realizzato	basic
significativi	tackling
pohjamo	civil
cenno	inadmissibility
recuperato	roots
apportato	pohjamo
continueranno	society
apportare	outlines
significativo	don
modelli	norway
macroeconomici	unemployed
indicano	bodies
indicato	participate
influenzata	post
fattori	pacts
markov	austere
poc	approve
raschhofer	insufficient
vacanze	utilising
dotazione	internationally
stranieri	regarded
migliorata	access
telegraficamente	whatever
fissazione	itemise
negoziato	aparicio
parti	steer
associativo	quickly
enti	closely
promotori	addition
trascorso	loaded
avrete	exceptional
fiasco	ambition
oratori	cocilovo
precisa	exist
suggerite	lies
stanziamenti	powerful
consentita	flexibly
vado	demonstrate
errato	adapting
abbiate	hypothesis
sensibili	onto
teneva	satisfy
consentisse	man
salto	friendly
21	unable
esamina	gdp
definizioni	memorandums
promossa	namely
scambio	differentiating
petersen	added
quinto	drill
positivi	getting
motivazione	hoc
complicata	financial
informo	barents
organizzare	strategically
seminario	equally
hedkvist	shutting
divisione	belatedly
applicata	oppose
mappatura	abstentions
ritenersi	communications
soddisfatto	spoke
avranno	principles
elenco	disagreed
sommersa	completed
avvenuto	maintained
primaria	commissioner
speranza	worse
auguri	engaged
ripartiti	ratify
cominciare	lorries
esserci	surely
stagnazione	ground
recessione	strictly
generano	simplifying
ribatterete	refers
penuria	mccarthy
valgono	berenguer
periodi	strictly
ripartirla	infrastructures
assenza	concrete
decenni	groun
or	temperatures
realizzati	adhere
verificatesi	be
99	badly
006	allowing
0120	catastrophe
2123	crashes
segna	disabled
passaggio	hospitals
mette	south
invitarla	critical
quinta	monies
vera	write
medio	systems
violente	introduce
immagine	mainly
monca	motives
trasmesso	passing
proclamato	sense
fondata	delayed
maltempo	profile
differenza	enjoyed
cercato	here
chiarire	euro
vist	deletes
sottoposte	west
confortare	contrary
concezione	situations
discorsi	evening
opportuna	october
tratte	relatively
pacifica	protect
valida	met
cooperazione	disbursed
riconciliazione	call
consolidata	alexander
0107	requirement
congratula	facing
sottolineando	killings
legame	introduced
periferia	share
esita	bernié
espliciti	indicated
policentrico	earned
lanciata	socialist
conti	propose
segnatamente	prevention
autore	attitude
globale	lament
81percento	reduce
kumar	nothing
migliorerà	examined
migliora	foggy
unità	mentioned
tecnologica	system
speciale	entered
relativizza	methods
morti	analyse
condoglianze	terrible
oltremare	extension
approvato	heard
invita	passionately
riservare	objection
inviasse	drew
danneggiati	compulsory
specificamente	2001
prossimamente	fifth
venuto	confirm
argomentazioni	enormous
interessanti	evolving
ottica	adapted
ponnambalam	elisabeth
equilibrato	separates
sanzione	path
valutazioni	concerning
ex	appealing
ante	immediate
specificare	undertake
riescono	elisabeth
confermo	debating
nutrire	municipalities
quote	believes
sostituire	connected
peraltro	transparency
dichiararlo	sphere
ministri	subsequent
tampere	round
redondo	twofold
jiménez	reserves
rispondono	angelilli
duplice	study
scorsa	uneven
discorrendo	reiterate
prende	questions
attengono	reaching
vademecum	vague
metodologico	hitherto
portavoce	inequitably
affermazione	towns
ricollocata	sincerely
collegato	related
primavera	contributions
attenuta	external
prevede	municipalities
vocazione	increased
indicativi	quickly
pertinenti	kilos
concordate	reservations
letteralmente	factor
raccomandazione	useful
143	coming
colpito	individuals
coste	strong
richiamo	reservation
suggerimento	hindrance
riservo	along
coincide	free
seguirò	realise
trarre	defects
lottare	substance
approverà	technology
carta	elections
riconosciute	unquestionably
lussemburgo	northern
fornirà	pursuing
recherò	exclusive
gravemente	proof
pluriennali	fore
sorta	credibility
riconoscono	land
diversificazione	decentralisation
cofinanziata	throughout
6	vice
multifunzionalità	else
iscritta	hasten
auspico	castro
moneta	construction
cunha	tunnel
formulerò	forego
specifica	statistics
ultime	expense
ricollega	detail
inammissibilità	lesson
prevista	cargo
lezioni	net
veda	vast
assoluta	whereas
citati	recovery
marginalmente	rule
sostenibilità	regrets
impostazione	regulation
ingiustificata	granting
tengano	thereby
summenzionati	undoubtedly
adottata	continuing
letto	completion
brandeburgo	rich
conosco	received
mozione	advertising
parallelamente	recall
speciali	background
sovvenzionati	basically
appropriati	corresponding
unicamente	sounding
telecomunicazioni	assis
inserendo	forward
ferroviarie	vivid
transeuropee	severely
2007	barely
indifferente	aptitude
attive	country
preferibilmente	combating
previsti	lacks
applicando	return
determinazione	relativises
sperequazione	context
storico	throughout
pecche	unnecessary
giornali	thanking
emarginazione	happening
ricadute	sole
disparati	rejection
espulsi	congratulates
produttivo	cohesion
flessibile	pronounced
conciliare	prolongs
personali	erika
favorire	damage
approfondita	nevertheless
stimolando	resumption
lavoratori	throwing
tenta	recommendations
crescere	probable
desumere	usefulness
cautela	sparse
alzarvi	surveys
sortiscono	targets
effetto	offices
sperato	puerta
osserva	iso
auspicata	accepted
mancano	mediterranean
basi	consistent
autonoma	chamber
contribuisce	logical
3percento	economies
ulteriori	appraisal
concentrandosi	sums
ammodernamento	profitable
auspicati	condition
effettuare	efficiency
razionalizzazione	trained
associato	instrument
alquanto	upheld
attuare	happen
professionale	monitoring
reinserimento	0107
nettamente	catalogue
rapporto	useless
periodico	appear
esplosioni	acceptable
disuguale	concentrating
teatro	linked
rapida	presents
crescono	insularity
ritmo	trends
sesto	continued
superiore	persons
meridionale	marks
continuano	worde
segnare	red
cause	addition
fenomeno	horizontal
ovunque	climates
assassinii	matches
rilevanti	recitals
unica	happy
individui	organisations
competitivo	consultative
presenta	direct
preziose	provider
riassumo	237
ricordate	sent
conseguiti	lowest
colpa	inaugural
fattore	rack
decisivo	exceptionally
diminuzione	contents
avvicinare	daring
vincolare	commenting
ordigni	austrian
approvare	presenting
presenti	agreed
sottoposta	twenty
tangibile	constructive
desume	nature
preoccupante	firstly
sentito	characterisations
237	heritage
coincidono	remoteness
corrispondono	occasion
4	administrator
riuscita	concluded
destinate	supporting
inequivocabilmente	eastward
combattere	scope
appropriata	drawn
spesi	field
male	section
statali	page
centralizzate	temperatures
consentano	monitor
distanze	slow
caldo	rehearsed
densità	colleges
assicurando	quoted
rimanere	result
impatti	nonetheless
ridotto	informal
inciso	vehicle
partner	orientated
televisione	ribeiro
bisognose	manage
flusso	lived
migratorio	25
motore	34
avanguardia	departments
operanti	centralised
appoggia	entirely
verificano	yourself
ignoranza	fourthly
coscienziosità	events
pregevole	reversing
occupa	surely
addetto	failed
nazioni	love
unite	fifths
svolti	overall
sforzarsi	grow
dirci	comprise
continuo	relative
rassegnarci	packaging
avanzamento	kumar
organizzazioni	employee
summenzionate	demographic
accelerare	decades
adottando	ports
notevolmente	mass
funzionare	college
diviene	examine
dotarsi	closed
pure	initiatives
sostanziale	construction
trasformi	ten
contingenti	sections
variano	renovation
semplici	spend
terrebbe	understanding
settentrionali	17
addetti	employers
rigide	reliable
conducenti	competitiveness
imballaggi	cunha
regolamentazioni	iso
lontano	aggravates
redazione	negative
necessarie	owner
molta	met
permettono	román
testimoniano	forces
rispecchierà	hopefully
parlava	feasible
inferiori	constitute
riuscito	attain
40	june
porterebbero	officer
formula	base
complementari	grew
dimostrano	volume
varietà	unknown
climatica	resolution
informare	channel
0106	passes
venissero	excluded
fermerebbero	tonight
confini	chapeau
senz	closed
0208	field
adozione	unambiguous
definita	office
austriaco	creating
on	drove
0105	poorer
rifletterà	non
facciamo	straight
completa	experts
ottobre	chairman
rammarichiamo	confident
causato	expecte
avvengano	directorate
migliaia	productive
tollerabilità	considers
scandaloso	damaging
esprimiamo	preserving
gratitudine	major
limiti	pre
disagi	producing
entrando	applicable
sperar	migration
resasi	preaching
decidere	visit
tutt	redondo
traffico	views
disporre	add
deviazione	substitute
beneficiando	methodological
lasciare	integration
presupposto	fashion
prevenzione	abroad
valori	0004
sostiene	book
area	preparing
infernale	straight
limite	leaders
quaranta	dates
certezza	augurs
immutato	findings
standard	fulfil
permette	constructively
effettuato	compliment
cambio	hidden
veramente	diminished
perfetto	moral
no	vigilance
notevoli	newspaper
transitano	simplifying
ferrovie	definitions
costata	simple
tauri	frequently
varo	advance
assiste	met
monti	enjoy
trasportati	explosions
debbono	observations
valga	fundamentally
memori	electronic
ringraziamento	austrian
vivamente	enhance
impressa	old
rimasta	satisfying
ricostruzione	accepts
sud	0083
contempla	appeal
nord	unnecessarily
arteria	ponnambalam
durati	ari
squisitamente	completed
vale	paying
pena	evaluated
traducono	redondo
distrutto	superb
assumiamo	limits
operiamo	marked
andato	vot
ricostruire	fifthly
sulll	disparity
tante	fell
ricorderann	farm
alleata	auditing
pensano	considered
analizzandolo	diversification
inizierò	power
illustrandovi	suggesting
tobin	raises
considera	obligation
tassa	best
avvengono	understand
potenziare	outcomes
circostanz	remain
destinatari	producers
investendo	inaugural
università	0104
istituti	held
eldr	dedicating
tranne	governing
emozione	appreciate
164	patience
garantisca	moreover
patrimoniale	indication
ritirare	midlands
pongo	crust
esiga	inadmissible
seattle	uk
suscitata	ourselves
detti	precisely
onda	official
lancerebbe	substantiates
modesta	control
apprendere	rightly
mantenere	providing
reitero	consultation
troppe	indicator
impoverite	fertile
ripetutamente	006
presenza	ultraperipheral
venivano	inject
considerate	afterwards
occupato	poettering
eliminato	literacy
arrivati	0105
opposto	constructively
dipendevano	compensated
investire	livelihood
grati	assessing
cosiddetta	anticipated
saremmo	boost
elettronica	border
ignorato	north
preparato	exodus
tornato	adopts
laureati	shortage
rimangano	dealing
netta	drivers
realizzabile	magnificently
decentralizzazione	interaction
universitaria	sorry
contribuirebbe	b
bilanciare	marginalisation
nascoste	note
desideriamo	recognise
logica	climate
interviene	segni
wurtz	discussion
elettronico	negative
diffusione	afford
facoltà	smoking
considerarsi	rejection
contributi	pleasure
tradotti	lowered
concretamente	transitional
avevate	insensitive
accorta	referring
ero	consequences
0108	electronically
coesion	health
maggioreprecisione	detail
0122	2127
2127	closed
effettuata	integrating
spiacente	powerful
riprendere	reluctant
utile	details
permettesse	savary
ritenerlo	emphasis
riporterà	justification
normalizzazioni	unanimous
caratteristiche	october
sollecitando	individually
accelerati	experiencing
scadenza	suggest
ritrovassimo	precise
inadeguato	saying
chiudere	reluctantly
dovessero	various
approveremo	acts
giustificano	direction
menzionato	loss
riportate	presently
chiare	planned
coerenza	edge
inaspettata	dissatisfaction
scheda	satisfied
elettronicamente	focus
deposto	predecessor
contato	thing
danneggia	asking
profondamente	plooij
riconoscimento	closed
pubblicità	connection
rappresenti	2003
astenuti	lasting
affronti	segni
7	certificate
legate	extraordinarily
166	know
deploriamo	underwater
cifre	reunion
ammesse	closed
grato	stay
saprete	imperative
manifestato	avoid
rispetterò	reassure
ovvio	rationalisation
guardino	limit
alleviare	without
premetto	changeover
immaginare	assessments
peggiorata	central
ricchi	0106
ampliato	counted
ristrutturazione	markov
consistente	probity
aggiungiamo	foreseeable
convinzione	act
simpson	37
dispongono	detailed
armonizza	enterprises
recepimento	concluded
realistica	refuse
discutiamo	ratify
creati	yourselves
averne	amount
obbligatoriamente	frankly
praticamente	consistent
scontato	ours
acquisito	overarching
consegnato	rates
margini	e
garanzie	exercise
continuare	join
contenenti	internationally
menzionati	please
importanti	universities
occorra	closed
limitare	ultimate
magnifico	emphasised
proficua	heritage
rendiconti	active
instaurata	criminal
genera	closed
attitudinale	indicator
container	cen
mescolarlo	loose
costrette	resumption
istituzion	moral
commission	peaceful
esistente	strengthened
straordinaria	communautaire
riprende	99
aereo	quantities
navi	visited
perfezionare	23
tranquillamente	hours
trovarsi	bug
viaggiare	employ
meteorologiche	viewpoint
marittimo	centre
trasportavano	fuster
navigano	routine
camion	execution
coinvolti	outcome
dichiarare	backward
rimasti	below
dedicarci	concerne
tanti	sho
avvenimenti	regeneration
margarina	closed
50	marginalisation
sensibile	budgetary
emerso	previously
accrescerne	commissione
merce	closed
trasportata	expenditure
giapponesi	worry
pericolosa	defined
favorendo	objection
chilo	profit
vernice	equilibrium
belgi	cofinancing
condotte	adequate
comportavano	allowing
autentica	segni
indagini	uncertainty
navigazione	attaches
commissari	rigorous
comportano	158
troverà	watered
attraversano	dilatory
fertil	culture
adoperarsi	12
crescenti	presidency
volumi	react
pregare	changes
marittima	makes
acque	examinations
constatando	instructive
19	death
marzo	texas
regolarmente	acceding
occupand	19
benché	defending
contare	reaching
avrei	unavailable
uniformi	rapid
uguaglianza	regular
diplomi	correct
esami	thousands
pio	enterprises
minimi	military
raggiunta	causing
attivato	greatest
consulenza	angelilli
35	corroborate
95	mediterranean
sancite	constitutes
limiterò	cofinancing
generi	brainpower
consapevolmente	shape
certificazioni	conceded
esorto	thematic
esercitare	distributed
attenta	resolve
sorveglianza	recitals
dovesse	explosions
adito	faced
9002	lot
iso	endeavour
normativo	meantime
toccato	sooner
eventualmente	hard
provengo	powers
assume	grass
peggiorare	stagnation
unilateralmente	myself
aziendali	safer
leggero	bush
tempestivit	denominator
proceduto	dispose
candidati	series
imputato	responded
attivarci	unfortunately
acquis	jiménez
concorrenziale	putting
auspicabili	annex
olanda	representing
normative	brittan
godono	intervention
scettico	scant
soddisfacenti	fleet
permettetemi	brought
occuparci	requisite
pronto	room
rete	european
qualora	ours
temperatura	prosecutor
lavora	rapporteurs
effettuano	closed
solito	portuguese
sciagure	imperative
galleria	compensate
chiudendo	humanist
incentrata	crossed
continuino	rose
lacuna	apply
veicoli	prevails
immatricolati	operate
manutenzione	significance
sapendo	superb
finisca	dissatisfied
aggiunga	cut
intendiamo	obtain
aerei	possibilities
riviste	overarching
giugno	committed
risale	35
norvegia	conservation
londra	struck
paddington	developing
modificata	wholehearted
evitiamo	distribution
figuri	vocational
stazione	requires
mass	fulfils
fissato	amending
tristemente	water
recente	postponing
consente	plooij
serbatoi	aims
introdotte	suffered
assicurarci	minimal
elevare	segni
rigido	assume
normativa	practically
resistenza	monopoly
basse	couple
certamente	latest
presi	positive
adibiti	resumed
pensato	gulf
venti	invite
intervenga	negative
vivono	uncontrolled
bacino	violent
mediterraneo	contrary
puntualmente	carefully
applicate	closed
emozionato	educational
ancor	minimal
amore	refusing
fortuna	memory
durato	correctly
minuti	definition
commentare	deliberations
sensi	single
leggi	stringent
solamente	farm
aggiuntivi	ease
accrescerebbe	easy
irritazione	networks
recepite	4
canto	links
deplorevole	things
normazione	informal
deploro	subsidiary
concerne	2123
comportato	models
fascicolo	admiration
adeguati	realistic
sviluppi	annually
paio	observe
dipende	deficiencies
costringe	hours
inadempienze	intolerable
altrui	0083
obbligherebbe	exacerbates
eventi	ratings
sicuri	seriously
legislative	generate
0083	compliments
dimostrare	transpired
belgio	earn
nebbia	experts
scorsi	floor
prodotti	affects
0104	dreaded
0004	centres
quanti	genuine
doterà	negotiation
guardare	among
basti	farmers
adr	opportune
armonizzati	advances
corsi	obvious
indubbia	penalties
validità	assist
attribuite	decentralisation
b	scale
emanazione	funded
severe	left
protezione	dealing
ridotti	consistency
scontata	bear
bretone	occasionally
costa	interesting
hoc	exploiting
largo	exception
stabilisce	ideas
petroliera	entrepreneur
emanare	brake
assistita	periodical
ecologico	doubt
disastro	criminal
accolto	ide
legislazione	socialists
restanti	constitutional
ripreso	bureaucratic
incertezze	author
sei	agreements
limita	serve
prolungare	reach
rinviando	operability
industria	beneficiaries
eliminare	gives
ritenute	wait
obsolete	pointing
disciplinare	decade
qualificati	assisting
motivati	ten
altamente	obstructing
maniera	guaranteeing
permettano	absolutely
versano	children
inviare	belief
peggiori	processes
emerge	2005
pericolosissima	reinforces
rinnovarlo	advisors
imposizione	require
irresponsabili	offered
risoluta	fail
occasion	alternative
concessa	answer
legislatur	unemploymen
arrivi	anyway
tardi	fischler
collettiva	apart
elaborati	combat
colpo	disadvantaged
esistenti	greece
produttori	commerce
tenuti	oil
succedendo	calling
vediamo	analysed
stia	wider
prendiamo	0120
indicatore	attached
coordinati	self
verifichi	berenguer
sbagliarci	transpired
parlato	alternatively
esplosiva	then
calo	indication
demografico	fischler
rinnovare	needless
principalmente	advice
vitale	intending
abc	urged
pubblicate	paddington
determinato	23
urbani	advise
riguardavano	scenario
riesaminata	pretext
avessero	possibilities
rinnovamento	procedural
viario	yourselves
spagnolo	compilation
acquee	identify
reflue	deadline
riferite	entail
opinioni	populations
fissati	inadmissible
lanciare	rating
compartecipe	unjustified
prenda	cox
rifiutare	assume
apparenza	tackling
burocratico	closed
sussistano	explicit
comunichi	room
scontento	demand
scapito	managers
estrema	address
verificheremo	fourth
confusa	links
confessarle	grandiose
cura	coinciding
rivitalizzare	conservative
18	rise
intera	according
concentrarsi	recognition
ricordando	extension
disuguaglianza	hospitals
ribadisce	subvert
attori	carried
coinvolgere	location
sufficienza	late
ritiene	contents
prenderne	possibly
votata	no
delinea	link
opponiamo	cross
eccessivo	route
centrali	advocating
rallentare	expanding
svolgimento	admit
monopolio	certainty
impiegati	met
proposti	damaged
sfruttata	keen
direttive	measure
aiuto	splendid
latere	part
scaturiti	brussels
raccomandava	faster
risoluzione	9002
perseguiti	particula
cresciuta	bring
dismisura	depopulation
spiegarlo	transpired
numerosissimi	delegating
dettagli	company
emersi	presentation
conoscenza	occurred
attualità	interpret
approdare	innocent
giacciono	energies
tenendo	pillars
quadri	absolute
proviene	delay
esaminati	heart
discussi	analyses
presentasse	bradbourn
elisabeth	claim
territori	man
discussioni	gulf
consentendoci	minor
invertire	right
tendenze	city
innocenti	mainland
determinano	undeveloped
interessante	entrepreneur
sostegnoo	bug
detiene	none
decisionali	prosperity
complessità	alleviate
organo	indonesia
investitura	díez
interessata	principal
efficienti	equation
capi	monies
esplicitamente	renew
estremo	pohjamo
gode	urge
accettata	currency
consultiva	anxious
subordinata	targeted
impossibilità	extents
negoziale	delays
edificio	stability
conferito	running
riconosciamo	arrangement
aria	record
rammarico	arguments
salire	telecommunication
treno	competently
corsa	available
riunito	earlie
ritenere	agricultural
test	genuinely
immediato	comparison
anticipare	established
condotto	18
rispetta	speed
influenzare	romano
esaminata	doubtless
farsi	responsibilities
bruxelles	disintegration
edifici	syndrome
antincendio	validity
allude	focused
allarme	turn
giunto	perceive
applicare	grateful
dovranno	ante
routine	difficulties
eseguire	1998
propri	tide
compiti	players
fatte	saying
rispettato	amendment
corrente	congratulate
dettaglio	service
latitanti	accuse
attraversando	schools
evocare	improves
ridistribuire	known
diversamente	unclear
tendenzialmente	constitutional
vorrebbero	harmonises
sparire	activities
accusano	astonished
coinvolgerci	commissione
laddove	progress
capaci	dilemma
dirlo	strictly
ripeto	secto
qualvolta	impose
porre	trumpeted
rimedio	human
gorsel	regeneration
raccogliere	apply
sovvenzioni	approximation
bastano	raised
carenti	55
porsi	mix
articolare	persuades
sussidiarie	obvious
risponderle	risk
trattare	marginalisation
plooj	varies
comporterà	advisers
significative	oversight
disponibile	comment
geografici	parallel
reso	hole
piste	users
stessi	changing
circolazione	irreparably
capitali	significant
sottoporre	fundamentally
importantissimo	multi
abbienti	multifunctional
organismi	broaden
lynne	dialogue
lasciano	eastward
libera	equality
vaste	population
vergognoso	impoverished
fumatori	meant
riservate	puerta
durata	properly
aiutare	recommended
fumare	ministers
renderli	trade
vertice	deeply
favorevolmente	re
attuati	weak
1989	voted
1993	affects
gonzález	sometimes
díez	endeavouring
consolidare	result
abbandona	aware
irreversibili	promotion
osservi	worst
operare	oversight
zona	fully
euro	edge
starà	produced
espansione	clarify
insulare	underwater
discostano	establishes
notevole	raises
ausilio	petersen
seguire	wealthy
istruzioni	observance
enfasi	keep
isolano	home
prestata	solid
apportate	towns
strasburgo	wrong
storia	refer
trascina	body
eletto	preparation
tant	supports
continueremo	shifted
doverlo	drew
congratulazioni	friend
età	unavailable
divieto	ratings
adulti	unjustified
disaccordo	impetus
debbo	lived
incoraggerà	thirdly
proseguire	50
rivolgerle	leader
dettagliata	piece
scale	urgent
relatori	literacy
allegato	cross
bernié	allows
migliorie	distant
faccio	interfaces
ribadire	leavers
quinti	openness
eccezione	urging
acquisiscono	advise
astensioni	willing
180	inactivity
ripercuote	becaus
ostacolo	rejected
422	developments
iscritti	exercises
andarsene	coasts
dispone	net
quarti	news
lavorano	drafted
part	enlighten
time	men
efficacemente	attend
prefiggerci	2127
posta	message
vada	chiefly
abbandoni	mentio
acconsentito	climates
presenterà	prosperous
oralmente	eldr
rilasciata	instrument
regolare	95
peso	extents
discussa	one
sport	ec
sanno	prevention
stagionale	compromise
diversificata	yo
accentua	entry
esodo	shows
costituiscono	brief
iscritt	key
sorpreso	macroeconomic
biodiversità	understand
agricola	forefront
pretende	assis
soglie	emphasises
xxi	visit
secolo	appropriately
multifunzionali	amendmen
aprendosi	embargo
conservazione	government
privilegiare	operations
assetto	partnershi
subito	finally
16	aviation
tratterà	subsequently
definire	nuisance
permanenza	borders
vece	paying
cultura	south
restauro	layers
fondazione	strongest
trasformazione	pertains
condivideva	aimed
approfonditamente	meaningful
ecc	original
esclusivo	schools
attendono	tampere
hänsch	suggest
sostituiti	imagine
disintegrazione	pre
succedere	markov
fantasma	short
svolgono	inadequate
biasimo	schroedte
grosso	vigilance
presentarlo	date
vostra	goal
eravamo	energy
ritenga	historical
trattano	stimulating
distinto	bomb
annuale	me
impegnato	telling
parlament	fall
combaciano	conservative
contestualmente	simplified
oggettivo	prior
sottoporr	logic
sperando	anti
200	who
pensando	bernié
compensando	attracting
estero	madeira
esorta	performance
veste	share
voluto	liked
vorrebbe	adjourned
cospicua	deprived
promosso	truth
socialisti	building
validi	reiterated
risata	extensive
energetico	presenting
vivi	expeditiously
ringraziamenti	intentions
spiegare	achieve
toccherà	ie
decide	implement
correndo	castro
sappia	strengthen
minimamente	modest
soggetto	decisively
potessimo	sure
trovarci	decide
rassicurare	closed
necessariamente	slowly
svista	listening
prepararci	operators
ripari	sectoral
mandato	143
esercita	discuss
ragionevole	pursuing
percorrere	166
terrei	emphasises
conflitto	suggestions
riferiscono	ter
estende	geographical
ide	shown
sussiste	putting
dolorosa	equation
carenza	educated
impressione	disintegration
disperato	cos
raccomandiam	7
egregiamente	gonzález
esattezza	afterwards
campi	province
conosciamo	reserves
collegare	reconciliation
ascoltando	distances
realizzata	enforcing
quinquennale	opposite
sconosciuto	relations
artificialmente	burden
programmatico	value
alta	tanks
tecnologia	workable
notizie	confused
diffuse	decent
distribuire	accept
perdendo	efficiently
prim	executed
industrie	produce
metodo	reprieve
determinanti	minor
istruttivo	kept
dice	margarine
originale	greater
tesi	deaths
formalità	competence
divulgato	flexibility
hague	recommendation
dura	adr
serve	1989
occuparsene	envy
normativi	anticipated
dirvi	friend
consapevole	century
obblighi	entrepreneurial
spostare	alert
andare	adapted
leggersi	nowadays
ambedue	abide
concentrassimo	staircases
incrementare	closed
efficiente	ill
riportare	acknowledged
valide	climatic
dicesse	guideline
rimetterle	concerns
carreggiata	condition
investitori	cities
elemento	commend
dilemma	tauern
giudicheremo	occurred
pongono	hat
rappresentata	discussing
solide	34
supporto	incomes
ess	educational
appieno	stay
ratificare	lesson
prosperità	amending
corroborare	discover
apparentemente	requests
sottoutilizzo	containers
significherebbe	corresponding
lasciate	hell
interpretazione	investor
funzionario	permission
amministrazione	repor
ipotesi	optimism
sostengono	instead
leader	requested
ampie	looks
indicative	inhabitant
assistenza	decent
gestori	flautre
beneficiari	deadlines
sfruttare	exodus
converrebbe	code
dinnanzi	evaluated
riflette	unacceptable
inserendovi	extraordinarily
mantenga	eventually
redditizio	keeping
eliminazione	outcomes
menzionata	quotation
scopi	raschhofe
concittadini	c5
convinti	stipulated
rapido	eyes
responsabilmente	sadly
comportarci	utilisation
veri	qualified
garantiscono	instructions
effettivamente	supervision
piccoli	costly
nega	misspent
priori	vacuum
formulazioni	gladly
compromesso	territory
valanga	bad
conosca	deadlines
segnalano	born
rilevanza	closed
rivolgersi	lastly
medi	pretext
scusa	supporting
portando	sphere
paradossale	discuss
ritrovarci	discredited
puramente	assessed
retorico	managers
verità	room
creerà	governing
privata	widen
unendo	news
pubbliche	ever
sinergia	tying
completamento	closed
comporti	management
chiusure	dramatic
esclusioni	fit
impresa	clearer
dovere	u
sciagurate	needing
riflettere	referred
conservatore	urge
permetto	pointing
ricordargli	rate
segretario	after
velocemente	prestigious
distribuzione	japan
sentono	lot
emarginati	arguments
ripristinare	greek
fruizione	cooperate
ricezione	dilatory
avremo	consuming
rinvio	societies
causati	destroyed
riuscire	cod
superare	removed
scommettere	participation
energie	advertising
sottolineo	quarrel
avvalendosi	passes
giustifichi	difficulties
