2705	legislative
improving	proposito
force	cunha
motives	infine
allows	tratta
143	164
takes	sapere
pointing	bretone
proper	sull
contribute	sufficiente
personality	forza
romano	temperature
pose	emerge
worthwhile	volentieri
spring	vernice
originally	scorso
strasbourg	energie
liked	vogliamo
much	figli
projects	memoria
2007	2006
20	15
cannot	quei
until	tutta
gradual	ambiti
population	locali
reluctant	nello
industries	gonzález
gross	olanda
impetus	motore
ability	principio
yourselves	soltanto
seppänen	pohjamo
festive	part
doing	qualche
participate	trasparenza
european	promozione
conservation	territorio
external	edifici
producers	aparicio
eldr	pohjamo
growing	donne
creating	vittime
indication	inferiori
preparing	pilastri
decades	internazionale
having	favore
rise	grandi
nations	costa
wee	pacifica
stand	o
entrepreneurship	comunitaria
hours	dolorosa
write	nulla
hard	ma
diminished	averne
depend	lieti
exclusive	presente
background	ivi
certificates	rigide
appeal	corsa
funds	vicepresidente
size	vari
consideration	infernale
two	giovani
enactment	disciplinare
what	vorrei
changeover	efficacia
bearing	desiderio
reserves	legislativa
has	risposta
speech	strada
circumstances	massima
considering	prossimi
targets	principi
paragraph	alle
february	dicembre
matte	valga
0105	0122
guidance	conto
agriculture	tecnologica
exercises	uffici
recommendations	incremento
lives	giorni
personal	ultima
electronic	quinta
dialogue	distribuzione
last	parola
way	lui
among	dello
rule	vie
valid	inutile
palacio	sri
factors	ministri
stay	mio
mid	vale
demonstrated	vocazione
answered	guardare
harmful	misure
catalogue	ricerche
know	spiegare
on	età
absolute	spagnolo
regional	sud
properly	legga
reiterate	determinate
informal	cura
combating	competitività
meaningful	valutazione
whenever	dirmi
connection	principale
relating	proposte
expressed	progressi
whilst	cambiato
discussing	globalizzazione
districts	lato
9	9
brake	berend
september	dicembre
employ	numerose
northern	grande
power	cittadini
non	prove
publicity	preso
analysis	pubblica
thing	senza
sources	società
continuing	trattato
sized	morti
summit	sorta
protection	carta
steer	tenuta
impression	passione
interregional	costa
hospitals	realismo
subjects	immagine
third	isola
debating	avanguardia
gives	vedere
point	vasti
commerce	permanente
find	che
azores	elevata
management	primaria
comprehensive	diritto
validity	indicazioni
step	ante
multi	formulare
per	all
market	merito
forthcoming	attuali
obtain	trattano
strengthen	dimostrato
pre	era
norway	serie
region	meridionale
ensure	competenza
challenges	sviluppo
sitting	trovato
round	se
officer	díez
crucial	dichiarazioni
related	relazioni
extension	sul
whereas	legame
here	quella
introducing	sulla
anticipated	oltremare
199	166
weeks	guida
sensitive	rilievo
employed	flusso
strong	ben
little	colpo
mass	mutare
feared	richiamo
enjoyed	qualsiasi
concerning	ricerca
prestigious	terziario
executed	sfide
week	fosse
2123	0105
move	prende
guarantees	facilitare
am	bei
1998	1993
seattle	merce
institutions	trasporti
sounding	visione
basic	origine
ever	giorno
medium	cappello
examinations	metodologico
dreaded	imputato
people	minuto
beneficial	risoluzione
focus	com
react	stati
demographic	agricoltura
austria	bei
completed	riflessioni
0208	0104
leaving	freddo
thank	arrivi
scrutiny	occupato
gonzález	sri
content	beneficio
reasonable	riconosciuto
communautaire	investimenti
pm	0208
aspect	quarto
feet	armi
requirement	registra
lack	minime
victims	cosa
1	2
d	b
chamber	mirano
adopt	relativo
cod	nn
benefit	cambio
times	assoluta
views	produzione
minister	quelle
diversity	illustrato
advice	possibile
total	sui
everyone	tocca
heritage	umana
factor	prima
handicapped	altamente
later	guida
speakers	una
tobin	hicks
given	francese
deadline	prim
republic	coste
initially	interrotta
conversion	pubblici
responsibility	avanguardia
inequality	unità
auditing	indice
fund	cambio
extensive	storici
forward	una
improve	mandato
peripheral	registra
after	alla
thousands	altri
assessments	approccio
construction	ferroviario
brussels	generali
first	reale
process	indice
essential	tenuto
firmly	nemmeno
determined	aggiunte
exception	progressiva
implemented	trattano
prepare	lì
telling	chiave
endorsed	contato
lacking	parlamentari
small	tre
finally	partire
commission	cultura
accused	parole
throughout	trattati
lays	le
item	hoc
hidden	tenute
minutes	poveri
amount	seguito
6	5
advisers	comunitaria
central	midlands
needing	intendo
puerta	lanka
writing	particolare
business	caso
challenge	america
left	io
should	vuoi
social	evoluzione
advocating	presentati
tread	sarà
explained	comunicazione
grou	carica
bureaucratic	priorità
comes	debbo
reform	parti
consolidate	pure
advanced	fase
phase	chiusa
changes	regno
these	occhi
were	fatto
from	nel
behalf	crescita
and	nuovi
damage	rotta
demand	maggior
vote	pronto
angelilli	indicato
attached	crescente
legislation	cooperazione
annex	orale
represent	appunto
stop	leva
greece	femminile
remain	voci
above	grazie
decides	sciagura
ill	intera
as	oggi
smes	determinazione
sides	assai
preferred	emerso
ppe	eldr
conduct	processo
appealing	comunque
instrument	varo
an	idee
gladly	chiede
did	bisogno
elections	lavoratori
legal	sociale
college	urbana
conference	wurtz
potential	storici
referring	decisioni
conclusions	uniformi
aspects	attività
desired	ciascuno
united	costa
policy	fondamentale
delay	gravi
face	noto
already	stessa
cause	zero
rich	sue
compliment	definiti
wealth	legislativo
tape	legato
about	siamo
targeted	monetari
policies	trattamento
eu	ecc
undertaken	svolgimento
fruits	canali
right	io
bridge	basa
before	giusto
those	uomini
ad	occasion
convenient	accusa
hitherto	ricchezza
euro	all
94	94
texas	farsi
province	area
ones	passaggio
obstacle	entro
standards	cultura
1999	1994
stimulating	menzionato
objective	chiari
historic	umana
work	faccia
firm	dello
treat	hatzidakis
addressed	ricchezza
whose	effetto
austere	priori
zoning	complementari
oversight	comunitaria
differently	venticinque
due	so
quite	stesso
retained	lunghe
group	completa
understand	dirmi
extending	olandese
educational	centro
better	vuoi
shown	devono
progress	metodi
extremely	portogallo
result	quali
too	figli
all	momento
lesson	venti
introduced	rapporto
commissio	collegamenti
unemployed	preferito
sri	valida
worth	dare
gesture	principio
goal	basti
shipment	affronti
modules	membr
industrial	sinergia
newspaper	numero
year	mondo
equally	trattano
genuine	markov
negative	positive
stated	utilità
section	ferrovia
distances	altra
speeches	tendenze
employee	solenne
visit	fini
free	tenere
shores	dando
represented	disposizione
ownership	consiste
bureaucracy	agricoltori
purely	auguri
tailor	signora
crash	com
concerne	coincide
dealing	strategia
guidelines	periodico
unable	audaci
intentions	capi
amending	pianificazione
created	criminali
engaged	straordinaria
enforcement	abbia
hicks	hicks
born	londra
uk	ritmo
paying	vigile
also	aspetti
yet	ogni
stands	sono
differences	direzione
exciting	il
emphasis	notizie
exit	nome
next	stata
open	veste
unfortunately	apparenza
missed	vita
everyday	semplicemente
charged	risale
marked	pare
facts	venti
rejects	chiaro
if	voi
reflect	certi
harmonisation	terziario
none	mesi
disparities	attuazione
proposed	naturali
reason	pronti
definite	or
brief	maggiori
suggests	ulteriori
prosperous	loro
sec	state
inhabitants	oltremare
measures	appello
but	dunque
application	arteria
entering	passo
agreement	prive
viewed	attuali
real	pil
3	3
wrong	faccia
dramatic	urbane
fundamentally	sommersa
requests	errore
procedures	efficacia
acknowledged	dibattito
compromise	sorta
intention	porti
back	venuto
areas	definita
manner	idee
presidency	orale
organise	investire
condemned	capaci
de	media
jiménez	sri
situation	quadro
valuable	ed
framework	arteria
late	città
research	tecnologica
member	marea
boost	pecche
cities	corso
friday	ben
feel	voglio
preaching	divenire
farm	dam
earlier	conoscenza
inevitable	buona
appropriation	integrazione
start	esse
him	restano
general	barón
poverty	pesca
accumulation	autorità
agreements	efficace
principle	superiore
anyway	sarò
silence	tenute
can	conosco
measure	segni
lessons	settimana
ministers	partenariat
appropriate	quasi
connected	secondo
requires	numerose
individuals	dovere
attitude	vaste
inhabitant	raccomandazione
worde	avanti
ease	preciso
keen	spero
anything	perché
sent	est
vast	semplici
netherlands	internazionale
technologies	dispone
budgetary	orientamento
attach	visibili
shutting	modalità
55	37
life	dalla
envy	grech
cost	sta
decisions	parola
renewable	parlamento
quota	2127
strategy	unito
order	cosa
obligation	corretto
ladies	fantasma
evidence	relazioni
ports	fertil
begin	possa
scale	base
transit	quinta
lag	invidia
repair	mandato
daring	medi
innocent	grech
study	sociali
weak	segretario
submit	concessa
escape	vado
román	sri
chairmen	vece
light	redondo
0106	0104
frankly	tempeste
some	oltre
follows	fattore
representatives	rigide
edge	noto
test	offra
dependent	grati
pay	dai
developments	grecia
activities	processo
adopting	colleghi
achieving	ostacoli
politicians	ruolo
kept	ultime
thinking	qualche
hold	voler
execution	latere
implementing	organismi
crashes	scheda
role	lavoratore
sufficient	aiutare
belgium	europa
15	15
ten	state
safe	solito
type	1200
0004	0122
entrepreneurial	orientamenti
tackling	addetto
treaty	agricole
date	note
simplified	presenti
díez	sri
renovation	recente
spend	vedremo
under	nikitin
things	ancora
closing	buon
floor	mezzo
permanent	transito
value	appello
followed	oltre
0120	0122
buildings	fondo
report	restauro
finnish	serie
transitional	commercio
session	tranquillamente
visited	dritto
incumbent	unanime
fuster	sri
how	vuole
means	aiuto
running	carenza
taxpayer	decisioni
opinions	elettronica
bound	sei
expectations	terribile
truth	trovato
wulf	wulf
wales	verso
causes	protezione
technology	seminario
condition	velocità
superb	senso
representing	istruzioni
consistent	membri
person	armi
hat	quelle
expanding	inferiore
disparity	settentrionali
7	9
authorities	ecologico
breach	ordine
proved	ricordare
couple	produzioni
reaching	stesso
relations	informazione
operation	º
regards	ridotto
renewal	centri
believes	conosco
advisors	consultiva
involved	permesso
monitor	solidi
strictly	piccolo
points	vasti
efforts	alimentare
recitals	schroedter
roots	denaro
knowledge	privata
willingness	trarre
presenting	quaranta
moral	resistenza
peaceful	letto
carried	prese
sentenced	chiaro
solely	contenuti
fell	nelle
crossed	porti
own	silenzio
calls	apparente
broad	calato
leader	vatanen
successfully	decisioni
administration	cultura
concerns	decidere
maintained	riflessione
union	turismo
lapland	quinquennio
slow	tali
successful	potere
loaded	tenta
against	mercato
weight	fede
placed	conoscenza
discover	figura
locating	modalità
matches	leggero
earned	avere
representative	sociale
ter	0208
think	chiedo
proof	vitale
along	suoi
tool	primis
approved	enorme
functional	facoltà
substitute	canale
november	dicembre
rural	agricolo
fashion	uno
greatest	poco
day	dalle
human	strada
realistic	povertà
events	strati
went	anche
chapeau	definiti
economies	amministrazione
notice	generali
join	vero
check	esse
her	oltre
effects	deboli
entrepreneurs	investire
originated	specifico
procedure	procedure
fight	mai
cooperate	informare
frameworks	elevati
agenda	adr
nature	comuni
july	dicembre
facing	ragione
global	monetaria
berlin	ess
guarantee	importante
predecessor	mezzi
briefly	ricezione
hatzidakis	seppänen
governments	responsabile
sincerely	auguri
looking	verità
training	sede
confidence	capi
labour	socialista
great	ponti
contribution	gestione
operations	º
gone	sarò
situations	speciali
concentrating	menzionato
acts	poche
brittan	flautre
surveys	geografica
investment	legislativo
commissione	iso
advance	dice
table	navigazione
backward	francesi
reference	centrali
petition	patrimoniale
joint	peso
adjacent	risultati
drawing	galleria
imperative	imposta
months	guida
matter	quello
income	assemblea
fit	rapido
alternative	significative
specifically	decennio
strongest	tipi
compliments	preferito
resolution	tasso
safety	trae
significance	ricerche
methods	facoltà
tampere	austria
annexes	ferroviarie
opportune	precise
thorough	possibilità
focused	proposta
permission	vostro
positive	positive
though	davvero
author	particolare
alert	calato
together	insieme
matched	presenti
may	pongo
currently	effetti
inject	venisse
able	immediato
aided	stia
affected	peggiori
used	vedere
society	europeo
occasion	semplici
withdrawn	trasparente
card	xxi
towards	degli
alleviate	relative
mathies	poettering
prodi	status
luxembourg	esso
profile	codice
milestone	durante
respond	decisioni
precise	normative
forces	cunha
documents	progetto
fully	vostre
sustainability	periodo
elimination	nei
defending	sfida
government	utile
myself	vorrei
average	immediato
almost	troppo
men	posto
through	spazio
sweden	serie
southern	grosso
railways	estero
decisive	data
assessment	politica
opportunity	politico
prepared	quotidiana
layers	organo
relate	gestire
yourself	vorrei
initiatives	legislativa
decent	prova
delays	eccellente
principality	piste
mentioned	possibilità
populations	prodotti
loss	collega
allow	portare
interest	speciale
precisely	chiesto
resumed	gravità
assistance	tecnologia
such	dieci
biodiversity	tecnologica
eastward	seduta
past	secondo
live	presto
eyes	domani
brandenburg	koch
distance	norvegia
ide	unica
law	cosa
level	visita
wurtz	merita
ex	ex
true	vada
solid	corsi
traditional	divenire
gap	essa
programmes	prestigio
rejected	permette
technical	comportamento
ec	d
reality	ai
apart	sotto
funded	vigente
colleagues	trasformazione
forget	vivere
naturally	mezzo
vague	posti
lowest	aggiunte
offer	orario
types	progetti
employment	assemblea
worrying	vedremo
account	equilibrio
finding	dati
faster	cautela
enterprises	gonzález
roads	nera
proportion	diretto
revenue	en
supported	quotidiana
vacuum	desidero
making	alla
seriously	possibile
openness	redazione
widen	tale
instead	poter
adr	prim
corresponding	attualità
different	quartieri
mandate	scale
understands	nonostante
trans	rack
oppose	integrate
accepted	inutile
infrastructure	beneficio
that	più
root	prospere
societies	organizzazione
invite	ottimo
called	quelli
addition	raccolte
particular	tra
going	lontano
avoid	eccellente
direct	porre
vigilance	redondo
bear	durante
remembered	ricordo
redevelopment	mantenga
press	nazionale
more	siamo
counted	chiede
wonder	segue
relatively	trattano
50	40
high	urbana
twofold	dettaglio
financially	dettagli
deviate	a
shifted	innanzi
will	me
detailed	atti
body	sui
indeed	questi
nowadays	andrò
accomplished	margini
explanations	sviluppi
stagnation	limito
amongst	piedi
committed	territori
water	cospicua
ourselves	eravamo
led	credo
viable	estremo
house	van
denominator	potersi
why	vuoi
mrs	guardino
recent	sugli
a5	grave
civil	capitale
said	quel
exceptionally	cenno
mean	lieti
pillars	galleria
laws	rurale
ghost	romano
article	fascicolo
serve	allude
enlighten	unicamente
strategic	º
º	dover
giving	invece
equation	giustificata
access	beneficio
capabilities	interesse
compilation	deciso
comparison	costituzione
proceeding	programmazione
happens	dirmi
exclusion	centrale
course	tecnico
necessary	terribile
contents	esercizio
inherent	membro
request	modo
appreciate	permette
poor	ultime
arguments	imprese
doubt	crescenti
your	quando
play	ho
directly	medesimo
ongoing	accordo
accompanying	notevole
pity	là
capable	incremento
return	vero
area	mantenga
via	quest
required	citato
brought	altro
service	urgente
investor	legislativo
99	94
greek	nelle
rose	monica
tauern	assistenz
success	leggi
since	dagli
paddington	pongo
waterway	loro
rapidly	decisioni
praise	verrà
damaged	fino
kinds	piccole
supervision	territoriale
includes	analisi
appraisal	giuridico
courts	nord
180	180
inequalities	programmi
differ	compresi
setting	fiducia
smaller	intero
employees	monopolio
net	arteria
innovative	logico
low	sta
reservation	punti
tend	speciali
anti	alternative
highlights	russe
owner	tant
are	detto
raising	serio
base	memoranda
immediately	povertà
rapporteur	indicare
supplements	bisogni
enjoy	completamente
organisation	sistema
financing	vigente
vice	zimeray
pursuing	bisogni
petersen	elisabeth
continued	misura
respect	lasciare
paid	violente
bodies	acque
21st	primavera
understood	tranne
growth	tribunale
implementation	incremento
possibilities	privato
unemployment	presidenti
products	intento
taking	quelli
pleasure	ultimo
future	repressive
hot	bozza
quoted	motivi
shape	bene
tax	basse
regions	promozione
elected	speriamo
substantial	dichiarazione
quotation	dimensione
evaluation	edifici
fischler	gorsel
a	occasion
provider	invita
waterways	centro
adapted	questioni
america	zone
prosecutor	interne
alexander	amsterdam
state	or
van	elisabeth
separates	accento
17	17
perceive	compreso
cocilovo	mass
underwater	transito
seasonal	governatore
parallel	dei
tech	pena
learn	lavora
affects	spese
koch	van
personally	previsto
my	quando
rating	a5
culture	rete
rapid	scopi
minor	sec
deprived	elezioni
climatic	geografici
otherwise	inutili
between	delle
hole	ben
ie	illustra
environmental	periodico
formulas	assistenza
claim	ci
promote	decisioni
no	prova
might	che
powers	monica
revision	testi
mentioning	tematiche
loud	posso
significant	regno
publishing	cittadino
current	quarto
direction	intera
disaster	serio
around	qual
paint	mano
shows	tempi
repeat	intende
project	memoria
produced	incontro
eastern	sul
century	fattori
severely	dimenticato
reminiscent	alquanto
forefront	precedente
exceptional	elenco
intended	parlare
initial	sua
days	produttori
pulled	messo
supporting	programma
assessing	legislazione
providing	comunitario
fisheries	geografica
get	posso
tanks	atto
draw	pone
examine	obiettivi
monitoring	commercio
subject	medie
lower	isole
signed	diversi
elements	fonti
extent	efficacia
else	voi
behaviour	consiglio
2001	1999
three	giovani
commissioner	flautre
acquis	infrastrutture
apply	ancor
bad	parlo
opinion	quanti
played	donne
expressing	parlamentari
possible	aerei
practically	pericolose
relevant	crescita
entrepreneur	monopolio
stressed	andrò
extents	efficacia
spoke	aver
programming	quarti
9002	ue
losing	assenza
plays	incontro
minimum	deputati
june	marzo
satisfy	giunto
fifth	scala
involve	operato
highlight	meno
exchange	ministro
remains	testi
definition	logica
seventh	opera
appeared	lettura
structural	riforma
territorial	sud
historical	storico
adapting	tradotti
introduce	serve
share	a5
regarding	raccolta
diverted	discutiamo
rightly	esistono
useful	combattere
shall	faccio
drafted	però
outside	sesto
completes	accordi
overcome	noi
insufficient	dichiarazioni
influential	conflitto
have	tutto
express	largo
saying	pensare
exodus	tal
faced	commissario
knowing	lasciate
comments	alcune
same	giorno
networks	impulso
misspent	cocilovo
reprieve	imprenditore
environment	aula
coherence	conservatore
france	energie
implement	incremento
itself	mese
reasons	tempi
our	silenzio
motion	canto
promoting	prodotto
whatever	però
evans	norma
judge	tante
march	coup
competitiveness	consultiva
periodic	principali
permit	casi
reach	correndo
2	2
spending	verbale
closely	contesto
catastrophe	riserva
movement	questione
council	cultura
temporary	equilibrio
routine	attenta
adapt	imposta
list	tener
its	storia
indicative	precise
states	costa
substance	forte
barents	genera
broke	anzi
because	mentre
pse	svista
flexible	contiene
parts	voci
other	sulle
include	coincide
upon	tale
exist	esempio
trends	amministrazione
occasional	volumi
probably	inutili
satisfying	violato
women	posto
hindrance	parere
office	limite
priorities	governo
long	dall
essentially	avvento
important	metodo
enlargement	amministrativa
hit	crescendo
improved	ed
dates	pronto
managing	austriaco
desk	equa
specify	trattano
unclear	segnale
dedicating	teneva
action	basta
set	ce
somewhat	carattere
merely	varietà
lasted	volentieri
frequently	riflessione
reduction	gestori
starting	penso
affect	ridotti
reservations	punti
capacities	fondata
provides	pratiche
out	ho
owing	drammatici
supervisory	aumenta
efficiency	parlamento
ask	nulla
quickly	giudizio
field	chilo
competition	clima
elisabeth	partner
witnessed	ristrutturazione
book	dedicata
iso	ue
interventions	imprenditori
sixth	opera
administrator	interne
was	anche
mention	uniti
either	ovvero
colleges	aereo
annual	dell
alone	o
0083	creati
coordination	energia
raise	denaro
struck	merci
excellent	positiva
into	grazie
look	sé
municipalities	relativa
procedural	cauti
system	periodi
meant	quando
observations	ricerche
laid	sappia
reading	dilemma
importance	azienda
chairman	savary
necessarily	tempeste
wealthy	obiettivo
thematic	trattato
question	informazioni
volatile	i
declare	crescere
clear	dove
drivers	marea
educated	risata
requirements	incremento
deal	lotta
rigorous	giudiziario
relation	ricostruzione
decade	colossale
2000	1999
risk	sede
standardisation	investire
effect	legate
room	volti
rejection	riduzione
contrary	piacere
media	c5
fail	essi
eventually	farà
head	allora
thesis	aerei
supports	personali
decide	assume
frost	tobin
swoboda	raschhofer
improvement	pagina
terrible	migliore
mix	costi
practical	stranieri
established	altre
agree	dimensioni
complete	logico
aptitude	visibili
enormous	molte
speak	tornerò
by	rapporto
cross	germania
subvert	modificato
rail	puerta
ensuring	tramite
denied	cocilovo
never	scusa
location	tunnel
indicators	vigente
discuss	emozione
sudre	ferroviarie
below	signor
humanist	programma
indicator	inferiori
failed	faremo
criticisms	collettiva
credibility	rinnovamento
certainty	venerdì
had	scritto
hi	ide
diversification	interessanti
negotiation	benefici
transition	marittima
thanks	qui
internet	primis
subsequent	trattati
support	problema
grass	atte
continue	considerate
directive	concerne
moor	west
limit	vada
internal	rimedio
minute	reti
competent	rendimento
corroborate	normative
decisio	collegamenti
strike	nogueira
10	15
uniting	periferia
belief	sicurezza
laughter	ridotto
wishes	troppo
richer	sei
incomes	attuazione
communication	vertice
within	grazie
admit	facendo
thus	confini
0104	0106
four	giovani
tunnel	base
explain	essere
road	largo
put	prende
memory	nostri
governor	monca
duty	morte
involvement	disoccupazione
hague	energie
applicable	finanziamento
blame	coraggio
stage	massa
decision	sesta
territory	nostra
programme	commercio
seen	verità
attention	altezza
just	dirmi
responsibilities	attualità
want	vorrei
reads	altrove
hoc	standard
quick	trae
especially	ragioni
experiencing	essenziale
422	164
young	me
message	propria
confident	sanno
manage	ingenti
periodical	creare
amended	lontane
trained	citati
idea	idea
while	detto
germany	seconda
good	momento
expected	necessarie
thi	0083
foggy	tenta
although	stessi
barely	va
every	tutta
obtaining	individui
utilisation	rurali
few	giorni
afford	avrò
modest	seppänen
early	città
disasters	massimo
awaited	seduta
redistribution	partenariat
approach	applicate
skills	fase
observance	esilio
assure	elaborazione
uneven	riconciliazione
speaking	nazione
taxation	fiscale
dreadful	commesso
presentation	centrali
acceptable	opinione
pleased	impegni
hesitant	previsti
control	mandato
commitment	vademecum
macroeconomic	presidenza
please	quando
piece	poi
post	obsolete
heard	dove
still	vorrei
dissatisfied	offerta
would	può
energy	legislativa
problem	diplomi
leave	lascia
pleasant	vernice
harmonised	reddito
agreed	trattano
term	accolti
generated	presenti
usefulness	presentati
trade	patrimonio
always	così
meaning	scuola
overall	durata
mediterranean	apertura
sums	esperti
tonight	lascia
totally	siano
costly	memori
single	lapponia
islander	breve
presents	rende
helping	onde
standard	ue
interpret	programmi
results	atti
hopefully	permette
let	quando
opposite	mese
lasting	volto
arrangements	supporto
feasible	domanda
highly	discorsi
e	time
knows	stasera
urgency	variano
avalanche	tutt
afterwards	disastro
criminal	cosa
figures	venti
finland	serie
practice	servizio
inadmissible	respinge
regrets	ovunque
conclude	serve
issued	autore
enhance	individui
each	luogo
mind	assenza
large	navigazione
temperatures	odierna
the	della
concern	talune
december	settembre
reconciliation	centri
findings	contributi
concentrate	grandiose
intolerable	poche
dimension	quinto
could	siamo
slowly	disperato
equal	cerca
statement	voti
capita	ottima
told	altro
objection	parlando
become	entrare
detail	moda
25	15
carry	desiderio
34	35
criterion	stia
accurate	normative
cooperation	rendimento
tankers	detiene
response	latere
i	so
0122	0106
berenguer	seri
sceptical	settimane
concluded	ristrutturazione
north	vale
respecting	circolazione
enough	vorrei
held	strategie
yes	certo
votes	aveva
qualified	necessario
enforcing	coordinamento
latter	piccoli
meeting	seattle
require	operare
sensible	ultima
materials	istituzioni
coup	intesa
units	suo
subsidiary	facilitare
actual	svezia
2003	2001
evening	contempo
explosions	delicato
bug	salute
regulation	territoriale
now	voluto
removed	difficili
uniform	gravi
treatment	accolti
infrastructures	ferroviari
like	voglio
tide	vitale
universities	economica
pursue	potrà
observe	attenzione
defined	necessaria
local	utile
suggested	persone
basically	piuttosto
provision	verificare
data	note
lived	anche
read	chilo
number	vita
citizens	volta
rehearsed	desidera
gentlemen	le
resulting	particolarmente
cen	9002
gdp	vi
putting	fatta
fore	rack
hand	lieto
1993	1989
reduce	prime
key	quinti
fourth	scala
resolve	fra
national	oriental
pass	mi
reliability	millennio
invest	propone
distinguished	vademecum
administrative	tecnologia
kind	lieto
object	arteria
stern	erika
critical	nuova
bit	solidi
4	4
proposal	pratica
helped	concorrenza
5	5
drill	tali
productive	ottica
effectiveness	oratori
dealt	ricordando
modernisation	iniziative
nevertheless	dubbio
majority	rimane
final	valenza
legally	abbiate
richest	sfida
balanced	beneficio
advances	applicata
international	tecnico
markov	hague
midlands	west
re	male
conclusion	pio
concentration	ausilio
integration	collegio
air	nogueira
occurred	decisioni
com	fiasco
not	ciò
complicated	dico
mistaken	comune
period	regione
socialist	partito
subordinate	lampante
recommended	distinto
activity	accolti
consistency	efficacia
information	primaria
over	assunta
moves	magnifico
equality	giovanile
needless	calato
discontent	ritardo
lament	piani
links	permanente
allocation	servire
aviation	tecnologico
useless	godere
do	no
hence	vengono
oil	román
portugal	indica
easy	cada
urgent	ritenuto
call	vita
excluded	tornata
difficulties	altrui
desperately	ero
ships	atto
countries	regioni
threshold	secondi
consultation	previdenza
present	nazioni
new	carico
packaging	tener
companies	medio
disintegration	strade
route	barents
crust	angelilli
goods	voto
quarters	mare
ar	no
british	completo
understanding	scuola
negotiations	partecipazione
ground	spirito
themselves	ancor
youth	fronte
definitions	naturali
deadlines	inaspettata
familiar	quattro
satisfied	farò
best	tempo
prior	somme
cold	tenta
issue	consultato
obvious	certi
again	sarò
barón	sri
lies	fanno
flexibility	ridotte
opportunities	unico
temptation	monti
overseas	presenta
letter	tutta
lynne	sue
deserves	finalmente
towns	devo
legislative	partenariat
us	andando
love	vorrei
constructive	concordi
years	giorni
original	lancio
generate	or
delayed	fondi
legislature	cen
any	fatte
enable	ingenti
someone	vorrei
rebuild	cod
certain	posti
interim	commission
treason	vigile
consider	giunto
prevent	contesto
calling	denaro
you	aspetto
bomb	massa
penalties	responsabile
wrote	siamo
wish	dimenticare
rate	pecche
longer	stessa
agricultural	tecnologica
obliged	discutiamo
drawn	articolo
abroad	deviazione
workers	socialismo
second	reale
creates	titolo
fact	sicurezza
yo	vece
outlines	elementi
cargo	coup
admiration	gestire
righ	accetto
main	mai
come	in
available	metà
presently	brandeburgo
form	centrali
powerful	potere
81	35
users	elemento
attentive	operato
document	periodica
volume	termini
money	donne
suffered	condannato
departments	orientamento
maximum	lunga
technological	seminario
leavers	illustra
sort	tassa
changing	ragione
entirely	attori
burden	degni
speed	vasta
rates	tutela
principal	continente
responsible	comunitari
land	valga
show	ai
preserving	sostenibile
inaugural	correnti
propose	integrate
constructed	progressi
absent	passata
comment	corretto
fundamental	ospedali
criteria	continuo
once	ci
aid	ritmo
optimum	minimi
west	west
declared	discutere
worst	fatta
serious	rispetto
kilos	preme
natural	gruppo
sho	tali
castro	kumar
motivated	decisioni
assume	assume
appears	applausi
however	trattano
january	marzo
006	006
getting	fatta
b	b
sense	buona
groups	catalogo
grandiose	concrete
partly	galleria
ari	erika
35	35
so	se
transparent	corsi
consists	tradizionali
contains	materiali
issues	sezione
storms	bush
plan	norvegia
inform	precisa
clarity	grech
looks	vuoi
friendly	chapeau
1994	1989
logical	annuale
alike	vostro
soon	me
goes	fini
at	lettera
president	savary
instruments	varo
watered	permette
strongly	avviso
amendments	preparato
sparse	scale
asking	caldo
she	quel
most	mondo
consultative	accesso
polic	ampia
vocational	urbana
company	crespo
poettering	figuri
today	domani
adult	bozza
often	parlare
resources	tecnologica
examined	discussione
accepts	finanziamento
another	nostro
distant	maggiore
record	c5
code	cauti
attain	ritenuto
lot	sarei
full	resta
page	verso
major	sec
financial	consultiva
40	40
down	forse
risks	disciplinare
anxious	minuti
secretary	sudre
becoming	paese
spanish	terzo
man	abc
balance	quaranta
proving	presa
children	minuto
statistics	unito
fleet	ribeiro
clearly	quei
bridges	donna
synergies	investimenti
stretched	dritto
series	strati
resolutions	patrimoniale
finer	costi
appreciation	rendiconti
objectives	rendimento
reducing	ulteriore
oral	sistemi
positions	sullo
time	amore
electronically	efficacia
previous	discussioni
been	è
official	testo
operate	indicative
schools	tecnologico
planning	universitaria
less	tempi
remind	avrei
french	galles
voting	economie
their	uomini
produce	cos
approximation	diplomi
creation	strade
regular	wurtz
reinforce	scarto
suggesting	condizioni
disgraceful	ripresa
abc	entrata
additions	centrali
halfway	libera
death	crescenti
refers	operatori
added	necessarie
drive	canto
communications	definitiva
berend	gorsel
behind	ragione
priority	latere
very	ossia
allowed	giovedì
makes	viene
socialists	partito
steps	frutti
nogueira	mai
up	sé
turn	ora
suggestions	realizzazione
reserve	de
participation	controllo
remember	vorrei
prevention	periodico
working	significa
even	voi
vehicle	campo
ambition	aree
viewpoint	azione
violent	cinque
text	modelli
encourage	raccomandazione
badly	ecco
models	tribunale
incorporate	or
competitive	valide
currency	la
needs	meglio
monopoly	fa
we	fatto
excessive	giornali
holding	dispone
considers	drammatici
officials	rendimento
correctly	trattano
create	or
south	vale
specific	grati
perspective	società
keeping	berlino
refusing	permette
members	forme
use	regole
interesting	nuove
ante	obsolete
governing	partenariat
partners	siete
case	dam
according	sulla
failure	dati
linked	embargo
18	15
hasten	terribili
well	piedi
exploiting	individui
effective	appello
relates	condotto
encouraging	ringraziamento
ripple	pecche
shortly	sensibili
happy	lancio
hell	mie
acquitted	chiameremo
237	143
special	assetto
sea	morte
unavailable	espressi
centres	ecologico
active	nota
evolving	legislazione
capital	legislativo
erika	partner
mr	fini
combat	da
concluding	drammatici
path	dei
analyses	settore
improves	tratte
where	facciamo
keep	voglio
climate	commercio
ideas	gruppi
answer	amore
urged	diversità
chairmanship	orientamento
records	modificata
intensive	fine
seven	frutti
straight	dal
broaden	povere
occasionally	esodo
or	quali
partnership	peso
recently	sugli
known	attraverso
fields	corretta
coasts	indicatore
profit	dia
consuming	quadri
home	ma
mccarthy	ann
excuse	ovunque
recognise	avuto
subsequently	richiesta
place	mare
which	altri
margins	geografici
maintaining	originario
reunion	legato
realise	succedere
meet	sento
received	occasione
consequences	urbani
amendment	partenariat
166	164
sooner	scrive
subsidies	facilitare
sadly	sembra
protecting	personale
regeneration	regionale
without	colpo
describes	contenuto
effort	vigore
take	sempre
end	fosse
cos	gode
costs	conforme
lanka	valida
need	vorrei
passing	francesi
islands	genera
integrating	amministrativa
fall	grandi
political	nazionale
omission	allarme
five	tutti
link	est
gulf	grosso
grounds	presa
quality	punto
raises	termine
compulsory	normativa
short	moneta
observation	stazione
messrs	sostiene
highest	maggior
fault	veri
off	ho
dilemma	morale
limits	nostra
commandment	conti
being	fatti
away	visto
aware	grati
urban	mutare
build	contrario
geographical	europeo
scenario	via
dwellers	rimedio
12	15
product	parte
supply	presidente
several	prospettiva
achieve	capitali
discredited	molteplici
shifting	concezione
caused	bilancio
heading	subito
monetary	autonoma
conditions	ferrovie
indicated	aggiunte
jobs	prenda
onto	rivolto
traffic	forte
sign	vita
livelihood	parlament
19	19
completely	ovvero
wednesday	vivi
comply	superare
madeira	confusa
various	strumenti
city	volta
21	17
eighteen	troppe
influence	lavoro
transport	terreno
based	privata
this	già
climates	televisione
military	ampie
one	poi
ruling	fede
job	mette
attend	vedete
outcomes	trattamento
existing	riconoscimento
efficient	candidati
savary	industrie
passes	parliamo
evaluated	numerose
adopted	emerso
syndrome	detti
throwing	ecco
lastly	maltempo
stability	generale
enter	primo
difficult	capitolo
tools	principio
exists	portata
purpose	opportuna
ours	pronto
exercise	interno
segni	errato
regulations	norme
relative	data
disabled	socialismo
rather	vuoi
perhaps	messaggio
island	dall
regret	adesso
terms	esperienze
increase	appello
contributions	attività
including	documenti
presented	modelli
23	17
party	dico
initiated	menzionato
of	di
embargo	reso
compensated	concordato
convinced	sperar
inspire	importante
formally	ricezione
side	gradi
federal	abbia
in	in
kingdom	campi
closed	moda
orientated	plenaria
proceed	azzorre
provisions	disciplinare
proliferation	umanista
competence	primaria
concerned	cambiamento
renew	edificio
attaining	mancata
broadly	argomento
upgrading	auspicio
entered	ovvio
agrees	immaginare
simple	posta
dispose	integrate
reforms	impiegati
hop	alto
say	scusa
kumar	validi
involving	umanista
particula	collegamenti
deaths	limiti
allowing	trattano
grew	tardi
zone	area
easier	dirmi
unacceptable	esclusivamente
europe	promozione
developed	mensile
heart	tornerò
applause	ripari
details	recenti
recommendation	accordo
sánchez	sri
believe	adesso
everything	giunge
status	via
advertising	uno
accept	confortare
there	quella
distribution	attivo
truly	ormai
eurostat	eurostat
don	permane
chapter	maggio
possibly	proprietà
initiative	economia
sure	si
hope	dare
concept	reso
employers	significativo
solution	livello
schroedter	berend
terribly	permette
productivity	pagina
he	quel
c5	tauri
distributed	efficacia
further	varie
economic	autonoma
affairs	nazione
multifunctional	esistenti
reports	restauro
drove	che
austrian	russe
experts	positivo
guideline	vigente
optimism	oppure
is	anche
consistently	opposto
benefits	caso
crespo	sri
particularly	intelligenza
accident	caso
bush	sperati
help	onde
contributing	integrare
expenditure	determinazione
recession	andarsene
texts	problemi
drafting	comunitario
lacks	imputato
spent	inizio
assessed	interessanti
granting	indifferente
ready	desse
0108	0122
then	quali
generally	sufficiente
happen	voglio
mainly	cenno
thought	questione
schemes	indice
whether	stessi
sole	0120
devote	routine
located	nesso
greater	zona
contained	trattati
provide	cambiare
words	voci
chiefly	costruzione
applied	tecnologico
example	discorsi
processes	amministrazione
constitutional	sociale
accidents	conto
2006	2006
russia	seattle
identify	portare
158	166
institution	europea
send	questa
refuse	possiamo
advise	un
sport	sport
reached	catastrofe
instructions	esercizio
for	negli
me	avrei
improvements	cifre
receiving	portoghese
aims	economico
sealing	belgio
0107	0122
lagging	concordate
regard	fare
raised	passato
close	forse
event	banchi
his	ultimi
smoking	farsi
context	regione
latest	linee
instructive	ottica
dangerous	capo
television	tipo
it	colpa
managers	medio
reliable	contrario
careful	questi
despite	lavorare
1989	1989
appear	possono
london	teatro
vatanen	erika
prove	severe
listen	vorrei
players	vera
containers	tenga
nos	europ
etc	hoc
border	poc
deeply	ormai
whatsoever	esistono
handling	dispone
previously	oggetto
immediate	repressive
unknown	corso
tunnels	senz
remote	margarina
strategies	amministrazione
them	occhi
when	veramente
299	164
influenced	norme
globalisation	pubblicità
insensitive	proprio
word	anni
offered	cambiamento
sound	piano
ratings	de
loose	mia
attempted	profitto
machine	dura
directorate	cultura
defects	elevati
endeavour	agricola
requested	accompagnamento
assis	sri
act	vie
during	giornale
wished	speriamo
seem	lasciare
feeling	aria
95	94
excluding	popolazione
common	nostre
requisite	or
uncontrolled	previsti
dam	mette
favour	ultime
worse	perfetto
intervention	velocità
wants	meglio
confused	entrata
reflected	espansione
nuisance	formalità
willing	sei
astonished	pericolose
ignorance	dubbi
minimal	risalto
basis	applicazione
thereby	opportunità
aparicio	sri
constantly	chiedono
killings	mirano
taken	corsi
enforced	consulenza
october	luglio
confirm	superare
offices	ecologico
half	mare
pronounced	grati
who	meglio
linking	operato
considerable	produttivo
equilibrium	scuole
thursday	vera
lesser	originale
poorer	vacanze
structurally	interessanti
seek	speranza
unnecessary	trascurato
marks	cox
c	b
committee	cultura
administrations	ecologico
limited	presenta
dutch	galles
wait	lascia
wider	strategie
production	urbano
unified	creati
directives	commesso
mainland	genera
offers	ipotesi
chance	allo
living	cuore
review	giornale
cut	tema
resistance	ricevuto
included	metà
producing	ripari
bring	me
operability	fallimento
transportation	campo
recovery	genere
address	continua
debate	pubblico
demonstrate	numerose
far	formula
dared	speriamo
sector	aver
systems	seminario
strengthening	amministrativa
change	cambiare
building	patrimonio
u	anch
transparency	vertice
nikitin	tampere
channels	concordate
beyond	signora
cases	deve
exile	bacino
figure	competitive
needed	essere
energies	onda
destroyed	altro
topical	strumenti
nothing	vuoi
additional	dialogo
give	almeno
questions	ministero
februar	commentare
took	cose
absolutely	capo
organisations	prestigio
aim	tal
cunha	indica
rules	nei
plans	ferrovia
fire	romano
met	gode
many	figli
restructuring	vicepresidente
achieved	ascoltare
happening	pari
comprise	provenienti
perfectly	messaggio
listening	esprimere
protect	gente
country	vista
2005	2006
economy	assemblea
to	sì
carrying	motivo
news	numero
namely	condanna
unless	avrà
part	treno
resumption	patrimoniale
prime	diverse
incentives	metodologico
sir	mathies
manne	pensato
entry	ad
hear	vorrei
experience	passaggio
only	verrà
line	sé
regarded	pretesa
really	qualcosa
says	fatti
irresponsible	appena
granted	situazione
amend	teneva
madam	guardino
fairer	lentezza
done	volte
fair	uso
services	urgente
neither	dopo
refer	pretende
problems	conservazione
zero	offra
conservative	sspa
redondo	veda
pointed	migliori
establishment	ppe
whom	commissario
education	futuro
month	mondo
aimed	adulti
both	passato
friend	venga
probable	informazioni
development	universitaria
presidents	wurtz
be	questo
fifths	permanenza
margarine	cos
twenty	tutti
surely	eravamo
investments	palacio
discussion	costituzione
alternatively	colleghi
expense	inciso
transported	sensibile
seminar	impresa
depth	britannico
simply	quanto
follow	sé
ago	vostro
assist	basti
discussed	costruire
cohesion	regolamento
indonesia	costata
causing	necessità
portuguese	valori
industry	criterio
guide	dando
with	intorno
see	vorrei
six	armi
backed	porre
millennium	quinto
abide	permette
dawn	abbiate
demonstrates	svolgimento
reconsider	potremmo
carefully	realizzato
community	pesca
tourism	zona
others	presentazione
correct	elettronico
methodological	economici
huge	sindrome
outcome	specifica
adequate	inquietudine
make	voglio
patience	alibi
s	l
commend	presi
faces	spagnolo
self	pronti
higher	vaghi
using	considerazioni
delivered	maniera
levels	maggior
accession	indicatore
method	cittadini
japan	terza
red	fischler
indicates	interessanti
drew	nell
note	grandiose
than	paese
tying	solo
fellow	seppänen
purposes	documento
domestic	gran
coming	trovato
ultimate	al
renewables	decisivo
imagine	prego
develop	andando
school	urbana
degree	morale
planned	unica
scope	reca
profitable	riferimento
compensate	or
draft	sens
shortage	intervenire
grant	nell
fertile	far
accordance	provenienti
associations	prestigio
studied	avvenimenti
promotion	alta
actually	troppo
recognition	vademecum
explanation	istruzione
sectors	auspicio
tomorrow	domani
leaders	posizione
completion	belgio
terminating	efficacia
structure	azienda
ribeiro	kumar
justification	globale
considered	soggetto
go	separa
view	dai
sufficiently	tematiche
accuse	cause
cox	evans
recall	cui
treaties	ambientale
lead	tema
operators	laureati
farmers	limita
magnificent	frutti
2127	0106
internationally	ricezione
partially	ragionamento
occasions	piccole
amsterdam	energie
appropriations	comunitaria
16	15
paradoxical	contrari
boosting	elevati
degrees	maniera
impose	emerge
developing	parlamentare
old	ultime
arms	innocenti
concrete	priori
telecommunication	significativa
catastrophic	compromesso
following	stampa
proposing	ciascun
italy	seconda
asked	successo
vot	scopi
matters	ancora
explicit	vaste
horizontal	austriaco
borders	medi
meantime	coraggio
grateful	trova
plenary	statistiche
grow	voglio
observed	terzo
representations	collaborazione
hypothesis	consiglio
channel	lacuna
simpson	simpson
explicitly	efficacia
they	vorrei
earn	sapere
does	già
must	già
tell	non
convergence	marittima
moment	partenza
fill	voti
spirit	buono
pleasing	esistono
regulatory	monetari
parliamentary	sociale
define	procedere
quantities	criteri
interfaces	efficacia
performance	tempo
impact	banchi
seeking	ero
mentio	collegamenti
disappearing	piccolo
numerous	personalità
insurance	limita
opening	valenza
splendid	francia
sections	volumi
ways	poveri
uncertainty	sorveglianza
37	37
submitted	attuale
expansion	sens
signs	tenuta
seems	qui
sustainable	legislatura
reversing	molte
hänsch	hänsch
add	precisa
parliament	novembre
1997	1994
vivid	dice
worry	tanto
establish	precedenti
unanimous	fenomeno
referred	governi
proposals	qualità
made	oggi
synergy	urbano
individually	trasparente
examination	giuridico
prevails	cocilovo
certainly	sarebbe
certificate	materia
suggest	disposizioni
literacy	comunità
sorry	ancora
interaction	università
sphere	pacifica
principles	formazione
urge	prodi
funding	vigente
businesses	principalmente
annually	incidenti
increasing	rischi
therefore	cioè
voted	appena
persons	continua
analyse	condotte
inland	texas
arrangement	ristretto
position	basi
private	quest
interpretation	università
merging	duplice
provided	opinione
lankan	sforzi
quarrel	al
centre	industria
whole	meno
sometimes	vanno
public	rapida
logic	dolorosa
something	voglio
rack	vist
minds	capo
prosperity	orario
migration	unione
increased	spese
safer	problema
least	queste
health	economia
disbursement	disposti
establishing	finanziari
164	166
preparation	comunicazioni
integrated	evidente
